t;tr;ch1;ch2;ch3;ch4;sum
0;0;15;14;16;17;62
1;0;14;15;13;15;57
2;0;12;11;11;13;47
3;0;11;14;12;9;46
4;0;10;16;21;12;59
5;0;15;13;12;10;50
6;0;10;10;16;12;48
7;0;9;18;16;14;57
8;0;16;9;12;21;58
9;0;13;5;14;11;43
10;0;8;12;8;18;46
11;0;9;15;9;19;52
12;0;7;15;12;14;48
13;0;17;7;10;10;44
14;0;10;14;12;14;50
15;0;12;16;10;15;53
16;0;9;15;12;7;43
17;0;13;12;15;17;57
18;0;13;20;15;14;62
19;0;16;21;7;11;55
20;0;7;11;11;8;37
21;0;11;11;21;14;57
22;0;12;12;13;15;52
23;0;8;14;17;8;47
24;0;10;12;9;19;50
25;0;11;15;14;20;60
26;0;10;12;11;15;48
27;0;7;18;11;16;52
28;0;10;13;19;9;51
29;0;11;13;19;8;51
30;0;10;14;9;11;44
31;0;11;14;14;10;49
32;0;12;18;17;11;58
33;0;10;11;13;11;45
34;0;9;22;13;15;59
35;0;12;15;16;8;51
36;0;5;5;21;11;42
37;0;10;16;14;14;54
38;0;10;19;18;13;60
39;0;15;9;12;8;44
40;0;7;16;15;17;55
41;0;11;17;17;10;55
42;0;11;13;13;14;51
43;0;12;20;10;9;51
44;0;11;12;10;9;42
45;0;10;8;14;10;42
46;0;10;8;8;9;35
47;0;9;16;21;14;60
48;0;9;16;12;19;56
49;0;15;15;16;14;60
50;0;8;12;17;10;47
51;0;11;13;13;13;50
52;0;12;17;19;10;58
53;0;11;16;16;9;52
54;0;8;13;13;16;50
55;0;11;15;11;15;52
56;0;13;9;11;13;46
57;0;16;15;9;15;55
58;0;8;10;13;10;41
59;0;5;11;14;13;43
60;0;10;9;8;7;34
61;0;7;11;9;12;39
62;0;11;23;6;10;50
63;0;4;12;16;6;38
64;0;9;18;20;15;62
65;0;6;12;19;10;47
66;0;8;17;11;18;54
67;0;11;10;7;11;39
68;0;11;9;13;7;40
69;0;12;13;15;14;54
70;0;8;16;10;16;50
71;0;13;15;8;15;51
72;0;8;6;16;10;40
73;0;10;11;14;15;50
74;0;10;9;11;10;40
75;0;9;19;12;12;52
76;0;8;13;14;16;51
77;0;11;18;11;3;43
78;0;11;9;16;10;46
79;0;16;12;16;14;58
80;0;8;14;14;8;44
81;0;10;13;18;11;52
82;0;8;9;8;17;42
83;0;7;11;16;15;49
84;0;15;10;12;17;54
85;0;4;11;21;13;49
86;0;13;9;15;14;51
87;0;8;13;19;15;55
88;0;8;6;14;7;35
89;0;10;11;9;8;38
90;0;12;13;15;18;58
91;0;9;14;8;14;45
92;0;6;13;16;7;42
93;0;10;14;13;9;46
94;0;12;12;13;17;54
95;0;11;20;11;12;54
96;0;13;11;15;14;53
97;0;16;13;22;13;64
98;0;18;16;16;16;66
99;0;8;12;11;18;49
100;0;8;15;10;6;39
101;0;11;14;11;6;42
102;0;12;10;16;10;48
103;0;11;14;11;9;45
104;0;13;15;5;10;43
105;0;11;8;17;9;45
106;0;12;11;13;14;50
107;0;13;10;11;12;46
108;0;8;15;16;9;48
109;0;18;11;14;14;57
110;0;10;17;15;10;52
111;0;8;11;11;11;41
112;0;10;10;13;11;44
113;0;14;14;14;10;52
114;0;11;14;14;18;57
115;0;15;19;8;13;55
116;0;12;8;22;5;47
117;0;13;26;14;7;60
118;0;7;9;13;11;40
119;0;6;17;15;17;55
120;0;12;16;13;15;56
121;0;12;11;18;10;51
122;0;9;6;11;11;37
123;0;14;12;12;12;50
124;0;8;13;17;13;51
125;0;11;17;12;12;52
126;0;8;10;13;11;42
127;0;13;14;20;15;62
128;0;8;16;14;15;53
129;0;10;7;15;8;40
130;0;12;10;10;10;42
131;0;11;16;12;9;48
132;0;10;24;15;17;66
133;0;9;10;12;7;38
134;0;7;16;10;9;42
135;0;11;14;18;12;55
136;0;7;11;10;11;39
137;0;16;17;12;17;62
138;0;9;15;17;8;49
139;0;14;15;8;10;47
140;0;11;9;10;11;41
141;0;14;12;9;8;43
142;0;12;13;11;14;50
143;0;8;10;17;12;47
144;0;8;19;17;8;52
145;0;12;12;13;12;49
146;0;8;11;11;18;48
147;0;12;11;15;11;49
148;0;9;12;13;9;43
149;0;10;10;11;12;43
150;0;11;13;16;9;49
151;0;6;18;17;11;52
152;0;8;13;17;11;49
153;0;8;6;21;19;54
154;0;10;12;7;6;35
155;0;12;16;7;14;49
156;0;14;15;13;10;52
157;0;10;17;14;15;56
158;0;14;14;6;10;44
159;0;12;8;12;14;46
160;0;8;12;10;15;45
161;0;7;12;15;12;46
162;0;7;20;15;10;52
163;0;9;14;15;18;56
164;0;7;12;13;10;42
165;0;15;14;14;5;48
166;0;14;12;14;10;50
167;0;7;14;8;9;38
168;0;14;21;17;20;72
169;0;12;12;12;11;47
170;0;9;12;12;18;51
171;0;10;20;8;11;49
172;0;14;10;16;10;50
173;0;9;7;14;12;42
174;0;15;9;23;7;54
175;0;14;18;16;12;60
176;0;12;21;15;18;66
177;0;7;13;10;11;41
178;0;13;10;14;10;47
179;0;11;12;16;12;51
180;0;5;16;13;11;45
181;0;7;11;13;6;37
182;0;13;13;9;14;49
183;0;10;11;11;17;49
184;0;9;10;13;13;45
185;0;10;15;10;6;41
186;0;17;17;17;12;63
187;0;7;15;17;11;50
188;0;7;18;10;8;43
189;0;18;19;5;12;54
190;0;14;8;18;5;45
191;0;11;13;16;15;55
192;0;11;11;20;15;57
193;0;13;18;10;5;46
194;0;15;14;11;8;48
195;0;15;9;10;12;46
196;0;10;9;12;15;46
197;0;11;11;16;9;47
198;0;9;12;15;11;47
199;0;11;11;5;20;47
200;0;8;13;16;9;46
201;0;11;17;12;10;50
202;0;13;11;14;8;46
203;0;6;10;11;10;37
204;0;7;9;5;19;40
205;0;16;7;14;11;48
206;0;3;16;11;9;39
207;0;12;16;14;14;56
208;0;16;10;15;18;59
209;0;8;14;13;11;46
210;0;11;16;9;9;45
211;0;11;13;14;15;53
212;0;12;17;17;14;60
213;0;13;13;14;5;45
214;0;7;15;17;10;49
215;0;15;10;8;14;47
216;0;14;13;12;7;46
217;0;11;14;10;13;48
218;0;11;14;12;14;51
219;0;7;12;14;12;45
220;0;6;14;10;17;47
221;0;16;13;11;17;57
222;0;16;12;12;18;58
223;0;12;13;14;4;43
224;0;10;11;15;12;48
225;0;8;13;12;11;44
226;0;10;7;14;13;44
227;0;5;12;14;5;36
228;0;16;11;14;6;47
229;0;13;7;11;15;46
230;0;11;6;13;12;42
231;0;11;12;11;18;52
232;0;8;14;10;9;41
233;0;7;13;7;6;33
234;0;6;10;13;12;41
235;0;13;11;12;8;44
236;0;8;15;12;9;44
237;0;5;16;15;12;48
238;0;12;19;11;10;52
239;0;9;10;10;13;42
240;0;12;12;9;12;45
241;0;5;12;10;18;45
242;0;9;16;9;12;46
243;0;7;5;10;10;32
244;0;12;10;18;12;52
245;0;9;8;21;12;50
246;0;7;9;12;10;38
247;0;15;12;13;13;53
248;0;5;14;8;14;41
249;0;7;10;11;12;40
250;0;12;13;9;11;45
251;0;19;23;18;20;80
252;0;7;8;14;9;38
253;0;10;18;12;19;59
254;0;10;11;15;9;45
255;0;9;9;12;13;43
256;0;18;17;8;10;53
257;0;11;13;10;15;49
258;0;11;13;10;9;43
259;0;14;8;10;13;45
260;0;16;13;19;7;55
261;0;10;15;16;9;50
262;0;12;17;14;15;58
263;0;6;12;12;9;39
264;0;7;16;10;13;46
265;0;11;7;6;10;34
266;0;12;15;12;11;50
267;0;16;9;12;11;48
268;0;11;14;11;14;50
269;0;15;10;13;14;52
270;0;11;11;9;17;48
271;0;11;12;13;12;48
272;0;12;17;14;13;56
273;0;6;16;23;8;53
274;0;8;22;9;13;52
275;0;2;12;16;12;42
276;0;12;18;11;9;50
277;0;7;16;15;9;47
278;0;11;16;14;8;49
279;0;6;11;13;14;44
280;0;9;13;13;14;49
281;0;15;13;15;13;56
282;0;8;13;16;11;48
283;0;13;12;16;11;52
284;0;15;15;12;11;53
285;0;8;11;11;10;40
286;0;4;9;18;20;51
287;0;12;13;12;13;50
288;0;9;15;15;11;50
289;0;11;18;15;11;55
290;0;6;16;15;10;47
291;0;9;6;8;17;40
292;0;12;11;7;10;40
293;0;7;13;22;17;59
294;0;12;15;12;13;52
295;0;15;9;12;9;45
296;0;7;11;17;13;48
297;0;9;17;12;9;47
298;0;7;13;15;7;42
299;0;14;7;10;17;48
300;0;6;18;10;12;46
301;0;14;14;10;18;56
302;0;14;10;7;14;45
303;0;13;15;10;17;55
304;0;13;14;14;16;57
305;0;7;15;10;11;43
306;0;9;10;11;13;43
307;0;10;11;16;11;48
308;0;10;13;12;11;46
309;0;12;5;15;10;42
310;0;6;12;19;10;47
311;0;10;6;19;7;42
312;0;13;11;9;13;46
313;0;15;8;16;13;52
314;0;14;14;12;10;50
315;0;16;10;11;11;48
316;0;7;14;11;14;46
317;0;12;14;17;9;52
318;0;9;16;13;14;52
319;0;8;12;13;11;44
320;0;10;20;13;11;54
321;0;13;15;9;12;49
322;0;15;9;12;10;46
323;0;9;11;19;15;54
324;0;12;19;15;8;54
325;0;10;11;7;14;42
326;0;11;12;14;17;54
327;0;12;15;17;14;58
328;0;18;9;16;13;56
329;0;11;17;11;11;50
330;0;10;15;15;12;52
331;0;8;12;18;8;46
332;0;12;10;13;13;48
333;0;8;10;14;9;41
334;0;5;16;11;15;47
335;0;8;18;15;12;53
336;0;12;13;15;10;50
337;0;14;13;16;12;55
338;0;8;10;8;13;39
339;0;6;14;7;17;44
340;0;6;13;13;11;43
341;0;7;15;12;14;48
342;0;12;9;16;12;49
343;0;13;17;15;12;57
344;0;10;12;13;11;46
345;0;7;11;7;16;41
346;0;12;7;11;9;39
347;0;9;15;12;15;51
348;0;8;13;5;9;35
349;0;11;8;17;13;49
350;0;10;11;7;18;46
351;0;10;15;10;9;44
352;0;13;8;15;12;48
353;0;7;13;19;9;48
354;0;10;15;14;16;55
355;0;14;15;14;6;49
356;0;12;10;15;13;50
357;0;12;12;11;12;47
358;0;8;14;17;10;49
359;0;7;17;13;20;57
360;0;5;13;9;13;40
361;0;11;12;9;10;42
362;0;13;11;10;11;45
363;0;9;12;10;15;46
364;0;9;14;15;9;47
365;0;7;15;14;10;46
366;0;14;15;16;14;59
367;0;5;14;14;14;47
368;0;11;8;9;12;40
369;0;10;13;11;9;43
370;0;5;13;21;10;49
371;0;11;20;11;7;49
372;0;9;17;6;14;46
373;0;15;23;17;18;73
374;0;9;15;9;10;43
375;0;9;8;10;10;37
376;0;12;13;12;13;50
377;0;8;14;15;7;44
378;0;12;10;16;8;46
379;0;12;14;13;8;47
380;0;12;14;19;9;54
381;0;22;15;17;15;69
382;0;6;12;8;8;34
383;0;10;10;9;16;45
384;0;9;9;16;17;51
385;0;11;12;20;13;56
386;0;12;11;11;18;52
387;0;7;20;9;6;42
388;0;10;15;6;10;41
389;0;9;11;14;10;44
390;0;13;7;11;13;44
391;0;11;19;9;12;51
392;0;7;14;17;10;48
393;0;9;10;13;12;44
394;0;8;12;6;6;32
395;0;7;10;16;21;54
396;0;11;10;11;20;52
397;0;4;7;13;17;41
398;0;13;10;20;12;55
399;0;11;8;9;13;41
400;0;17;9;20;7;53
401;0;8;13;8;13;42
402;0;11;11;15;5;42
403;0;11;12;20;10;53
404;0;8;10;10;8;36
405;0;11;12;11;7;41
406;0;5;10;12;9;36
407;0;12;5;11;7;35
408;0;14;10;6;12;42
409;0;9;15;13;15;52
410;0;9;4;18;7;38
411;0;8;14;14;8;44
412;0;8;6;7;16;37
413;0;13;16;7;11;47
414;0;4;13;12;12;41
415;0;4;16;14;11;45
416;0;17;13;10;15;55
417;0;7;12;15;8;42
418;0;6;10;9;10;35
419;0;8;15;11;11;45
420;0;8;12;11;16;47
421;0;12;14;14;10;50
422;0;11;14;13;15;53
423;0;14;10;15;14;53
424;0;18;15;17;9;59
425;0;13;13;13;6;45
426;0;9;10;9;9;37
427;0;10;16;11;11;48
428;0;18;10;10;14;52
429;0;15;15;13;14;57
430;0;8;9;13;14;44
431;0;15;6;6;10;37
432;0;10;17;14;11;52
433;0;13;15;14;8;50
434;0;10;14;9;10;43
435;0;10;11;8;8;37
436;0;11;13;13;16;53
437;0;14;16;10;6;46
438;0;8;15;11;9;43
439;0;10;9;12;17;48
440;0;15;6;10;11;42
441;0;5;8;16;10;39
442;0;9;11;8;12;40
443;0;12;14;10;10;46
444;0;8;21;10;6;45
445;0;8;16;9;13;46
446;0;5;10;8;10;33
447;0;8;13;10;13;44
448;0;11;11;10;12;44
449;0;10;12;10;14;46
450;0;10;11;13;18;52
451;0;10;13;14;9;46
452;0;8;12;12;11;43
453;0;8;15;8;11;42
454;0;8;15;12;6;41
455;0;8;14;8;9;39
456;0;12;9;14;12;47
457;0;12;14;13;8;47
458;0;7;12;14;14;47
459;0;10;16;6;14;46
460;0;13;15;14;11;53
461;0;9;15;12;16;52
462;0;14;15;8;10;47
463;0;4;9;13;12;38
464;0;12;17;12;14;55
465;0;9;13;9;8;39
466;0;6;8;13;17;44
467;0;10;15;15;16;56
468;0;6;12;15;13;46
469;0;9;15;18;9;51
470;0;12;13;16;13;54
471;0;11;14;10;9;44
472;0;10;17;14;16;57
473;0;8;14;8;14;44
474;0;9;12;17;11;49
475;0;8;14;13;12;47
476;0;11;19;12;18;60
477;0;7;7;13;11;38
478;0;10;7;18;11;46
479;0;15;5;11;12;43
480;0;8;11;15;10;44
481;0;7;12;12;7;38
482;0;10;12;16;9;47
483;0;11;13;13;10;47
484;0;7;14;12;18;51
485;0;10;14;10;10;44
486;0;12;18;16;14;60
487;0;5;15;7;12;39
488;0;10;12;15;7;44
489;0;12;18;8;14;52
490;0;7;9;11;11;38
491;0;15;11;14;12;52
492;0;8;13;11;10;42
493;0;10;17;12;6;45
494;0;9;7;6;18;40
495;0;10;5;16;7;38
496;0;5;7;9;8;29
497;0;11;3;10;11;35
498;0;15;12;11;15;53
499;0;8;7;14;12;41
500;0;11;15;12;11;49
501;0;17;9;10;8;44
502;0;12;12;13;15;52
503;0;13;13;8;13;47
504;0;11;16;17;12;56
505;0;13;14;10;10;47
506;0;16;12;9;11;48
507;0;14;14;7;12;47
508;0;9;11;12;11;43
509;0;16;14;15;13;58
510;0;17;10;11;11;49
511;0;9;17;10;6;42
512;0;11;20;18;10;59
513;0;7;12;12;8;39
514;0;6;14;14;9;43
515;0;10;10;14;7;41
516;0;7;8;27;13;55
517;0;13;10;10;12;45
518;0;11;14;16;12;53
519;0;8;11;11;13;43
520;0;10;15;11;14;50
521;0;5;11;15;14;45
522;0;7;13;15;21;56
523;0;12;12;12;12;48
524;0;13;11;6;14;44
525;0;10;9;11;5;35
526;0;17;11;15;10;53
527;0;9;12;18;10;49
528;0;4;15;12;10;41
529;0;7;15;11;8;41
530;0;8;16;7;9;40
531;0;18;16;14;7;55
532;0;11;14;6;10;41
533;0;8;12;9;4;33
534;0;13;6;10;13;42
535;0;14;11;12;11;48
536;0;15;9;10;11;45
537;0;11;15;17;14;57
538;0;11;11;10;5;37
539;0;7;11;16;13;47
540;0;5;10;12;8;35
541;0;9;15;5;15;44
542;0;6;8;13;13;40
543;0;7;14;13;13;47
544;0;5;10;13;14;42
545;0;10;15;20;9;54
546;0;3;18;17;11;49
547;0;8;11;14;10;43
548;0;9;10;15;11;45
549;0;9;16;15;10;50
550;0;8;7;12;8;35
551;0;12;14;13;12;51
552;0;12;11;11;14;48
553;0;8;14;15;13;50
554;0;9;12;16;13;50
555;0;6;15;12;12;45
556;0;9;20;13;7;49
557;0;14;11;18;10;53
558;0;7;12;10;9;38
559;0;11;21;14;11;57
560;0;9;8;4;9;30
561;0;6;13;13;7;39
562;0;13;12;13;7;45
563;0;10;9;9;16;44
564;0;8;16;8;15;47
565;0;8;14;13;11;46
566;0;14;16;13;10;53
567;0;12;9;10;7;38
568;0;6;22;8;6;42
569;0;12;8;17;21;58
570;0;11;4;7;13;35
571;0;11;7;14;15;47
572;0;6;14;10;8;38
573;0;9;7;17;15;48
574;0;7;8;9;14;38
575;0;13;11;17;5;46
576;0;10;11;14;11;46
577;0;15;11;15;15;56
578;0;10;12;14;12;48
579;0;11;10;9;16;46
580;0;15;12;15;8;50
581;0;19;19;12;14;64
582;0;9;15;8;11;43
583;0;10;15;9;8;42
584;0;17;19;12;18;66
585;0;6;16;13;17;52
586;0;11;10;8;13;42
587;0;16;10;14;8;48
588;0;10;14;9;13;46
589;0;16;18;13;7;54
590;0;14;10;14;13;51
591;0;14;9;10;12;45
592;0;9;12;15;10;46
593;0;8;17;12;16;53
594;0;15;12;10;15;52
595;0;9;10;10;16;45
596;0;10;11;11;14;46
597;0;11;11;11;12;45
598;0;15;14;10;10;49
599;0;10;19;14;13;56
600;0;6;12;10;6;34
601;0;11;12;7;14;44
602;0;7;8;14;8;37
603;0;7;20;7;8;42
604;0;13;7;15;13;48
605;0;9;14;10;10;43
606;0;15;7;13;12;47
607;0;7;10;15;13;45
608;0;9;9;8;7;33
609;0;15;13;7;14;49
610;0;8;14;7;11;40
611;0;11;12;19;9;51
612;0;11;11;15;6;43
613;0;10;13;18;11;52
614;0;11;10;8;5;34
615;0;10;11;8;13;42
616;0;7;6;10;6;29
617;0;10;11;11;9;41
618;0;12;12;14;10;48
619;0;14;18;16;17;65
620;0;8;11;8;12;39
621;0;15;14;12;6;47
622;0;7;11;14;12;44
623;1;13;13;16;18;60
624;1;9;21;18;16;64
625;1;15;9;16;19;59
626;1;10;17;19;14;60
627;1;16;13;11;13;53
628;1;12;11;23;8;54
629;1;3;10;17;16;46
630;1;21;15;18;15;69
631;1;21;23;15;17;76
632;1;15;11;13;12;51
633;1;8;12;12;15;47
634;1;13;17;19;11;60
635;1;9;18;8;16;51
636;1;16;13;13;12;54
637;1;18;10;11;16;55
638;1;13;14;8;11;46
639;1;9;13;24;10;56
640;1;4;12;17;14;47
641;1;11;17;11;10;49
642;1;11;15;8;13;47
643;1;16;17;15;12;60
644;1;14;13;18;11;56
645;1;3;12;12;10;37
646;1;11;12;5;13;41
647;1;18;8;12;11;49
648;1;10;18;19;12;59
649;1;13;13;13;10;49
650;1;9;18;15;14;56
651;1;14;18;19;11;62
652;1;9;14;17;2;42
653;1;10;13;11;17;51
654;1;12;14;11;21;58
655;1;17;14;10;17;58
656;1;8;13;16;10;47
657;1;2;9;13;11;35
658;1;10;9;13;15;47
659;1;22;12;18;10;62
660;1;15;12;17;16;60
661;1;11;11;19;9;50
662;1;9;11;14;13;47
663;1;11;13;12;8;44
664;1;12;7;19;11;49
665;1;8;12;12;17;49
666;1;5;9;16;8;38
667;1;10;11;10;9;40
668;1;12;11;17;10;50
669;1;8;14;14;18;54
670;1;15;8;7;13;43
671;1;6;12;11;10;39
672;1;8;12;11;7;38
673;1;10;12;15;6;43
674;1;7;16;14;13;50
675;1;9;11;9;14;43
676;1;7;13;12;14;46
677;1;5;15;6;10;36
678;1;9;13;11;15;48
679;1;12;11;14;12;49
680;1;9;13;12;9;43
681;1;13;9;6;13;41
682;1;6;11;12;20;49
683;1;11;15;17;10;53
684;1;12;14;14;6;46
685;1;5;10;10;10;35
686;1;9;14;12;7;42
687;1;14;12;13;14;53
688;1;9;17;14;7;47
689;1;14;13;12;10;49
690;1;10;6;14;9;39
691;1;7;4;10;7;28
692;1;11;11;14;11;47
693;1;13;13;11;16;53
694;1;6;12;11;8;37
695;1;9;12;20;7;48
696;1;15;15;20;9;59
697;1;13;8;18;3;42
698;1;6;13;12;8;39
699;1;15;15;9;9;48
700;1;3;10;19;12;44
701;1;11;15;8;13;47
702;1;8;13;15;10;46
703;1;15;16;6;11;48
704;1;7;18;15;12;52
705;1;7;13;11;9;40
706;1;8;10;18;7;43
707;1;11;10;12;12;45
708;1;11;15;10;16;52
709;1;11;19;14;10;54
710;1;7;9;12;7;35
711;1;10;10;14;16;50
712;1;12;16;16;12;56
713;1;7;13;10;11;41
714;1;9;11;4;16;40
715;1;10;15;18;14;57
716;1;10;11;8;13;42
717;1;12;8;8;12;40
718;1;7;12;9;12;40
719;1;4;15;11;11;41
720;1;7;17;18;11;53
721;1;10;11;9;6;36
722;1;8;13;10;13;44
723;1;12;9;10;13;44
724;1;5;10;9;16;40
725;1;4;14;12;12;42
726;1;8;8;13;13;42
727;3;31;31;33;28;123
728;3;26;27;25;16;94
729;3;31;33;38;38;140
730;3;28;29;34;24;115
731;3;15;25;23;37;100
732;3;20;19;26;32;97
733;3;26;25;24;26;101
734;3;21;22;27;31;101
735;3;16;20;17;24;77
736;3;26;23;34;28;111
737;3;17;24;25;25;91
738;3;12;17;25;20;74
739;3;23;23;22;25;93
740;3;17;24;16;22;79
741;3;15;10;18;25;68
742;3;15;18;21;15;69
743;3;20;20;13;19;72
744;3;24;23;24;15;86
745;3;18;20;13;19;70
746;3;11;19;16;19;65
747;3;15;26;12;22;75
748;3;18;25;12;14;69
749;3;21;23;17;15;76
750;3;13;11;15;19;58
751;3;11;18;11;16;56
752;3;11;14;14;14;53
753;3;15;21;11;16;63
754;3;14;12;17;13;56
755;3;6;18;15;18;57
756;3;12;9;16;12;49
757;3;13;22;18;27;80
758;3;14;12;18;15;59
759;3;10;15;14;16;55
760;3;15;11;14;14;54
761;3;14;15;14;19;62
762;3;13;16;21;11;61
763;3;13;9;11;19;52
764;3;7;20;21;22;70
765;3;17;17;17;10;61
766;3;11;17;13;10;51
767;3;8;18;11;11;48
768;3;12;14;13;9;48
769;3;11;10;9;6;36
770;3;11;11;15;13;50
771;3;14;14;9;14;51
772;3;10;14;19;19;62
773;3;11;15;12;4;42
774;3;15;13;12;15;55
775;3;12;13;13;9;47
776;3;13;14;9;10;46
777;3;19;9;15;13;56
778;3;17;13;6;10;46
779;3;14;11;13;12;50
780;3;6;10;12;8;36
781;3;12;15;3;19;49
782;3;10;11;13;11;45
783;3;8;10;7;8;33
784;3;8;11;13;7;39
785;3;9;13;8;8;38
786;3;8;7;12;11;38
787;3;16;14;11;15;56
788;3;7;9;15;12;43
789;3;11;12;17;5;45
790;3;11;7;16;13;47
791;3;11;16;18;8;53
792;3;11;6;10;6;33
793;3;7;11;15;9;42
794;3;9;15;13;9;46
795;3;11;9;17;8;45
796;3;6;9;12;11;38
797;3;7;16;12;14;49
798;3;12;10;9;13;44
799;3;10;7;12;8;37
800;3;8;13;12;10;43
801;3;10;7;21;15;53
802;3;11;18;14;11;54
803;3;8;10;20;16;54
804;3;11;10;15;16;52
805;3;9;16;15;9;49
806;3;12;16;10;12;50
807;3;8;12;11;8;39
808;3;11;12;8;12;43
809;3;4;14;10;14;42
810;3;13;11;13;9;46
811;3;11;14;14;11;50
812;3;7;8;12;13;40
813;3;11;9;12;10;42
814;3;9;15;10;15;49
815;3;4;9;9;13;35
816;3;14;5;9;15;43
817;3;14;9;15;9;47
818;3;9;12;10;8;39
819;3;7;8;16;13;44
820;3;8;19;12;15;54
821;3;5;17;13;6;41
822;3;5;13;13;10;41
823;3;6;7;12;14;39
824;3;9;10;7;9;35
825;3;8;5;7;12;32
826;3;8;12;16;13;49
827;3;12;16;15;10;53
828;3;13;8;7;13;41
829;3;8;10;19;15;52
830;3;8;11;8;11;38
831;3;9;15;12;11;47
832;3;5;11;13;15;44
833;3;5;14;11;7;37
834;3;10;11;7;10;38
835;3;5;9;7;7;28
836;3;5;10;7;16;38
837;3;10;14;7;11;42
838;3;13;8;11;8;40
839;3;16;14;15;15;60
840;3;6;11;14;12;43
841;3;9;11;9;13;42
842;3;12;11;10;8;41
843;3;13;12;12;15;52
844;3;6;9;15;13;43
845;3;13;9;16;12;50
846;3;10;13;11;8;42
847;3;7;8;10;10;35
848;3;12;20;5;8;45
849;3;8;13;11;6;38
850;6;8;11;15;17;51
851;6;20;12;14;7;53
852;6;14;14;12;12;52
853;6;4;16;20;8;48
854;6;4;11;8;8;31
855;6;13;10;13;10;46
856;6;7;13;13;10;43
857;6;5;9;15;11;40
858;6;9;7;14;13;43
859;6;10;7;10;17;44
860;6;10;9;11;9;39
861;6;7;15;10;9;41
862;6;12;14;8;7;41
863;6;10;10;18;9;47
864;6;13;16;4;10;43
865;6;9;8;5;15;37
866;6;11;9;13;8;41
867;6;3;13;9;10;35
868;6;5;12;12;11;40
869;6;7;10;9;10;36
870;6;5;12;13;14;44
871;6;11;5;14;11;41
872;6;10;13;9;16;48
873;6;7;9;10;7;33
874;6;13;7;4;7;31
875;6;13;8;13;16;50
876;6;9;11;16;15;51
877;6;6;7;12;15;40
878;6;12;18;8;9;47
879;6;5;10;16;11;42
880;6;12;10;8;13;43
881;6;8;13;7;13;41
882;6;11;16;9;9;45
883;6;8;15;10;4;37
884;6;3;11;11;4;29
885;6;6;7;9;10;32
886;6;9;8;8;8;33
887;6;8;11;13;10;42
888;6;7;12;11;7;37
889;6;12;9;7;12;40
890;6;9;10;18;8;45
891;6;12;12;11;8;43
892;6;17;8;12;6;43
893;6;10;12;13;5;40
894;6;10;12;3;16;41
895;6;15;9;17;5;46
896;6;8;10;10;11;39
897;6;11;15;14;13;53
898;6;8;14;7;10;39
899;6;3;22;13;13;51
900;6;10;7;8;15;40
901;6;12;8;5;13;38
902;6;7;12;8;14;41
903;6;7;6;7;8;28
904;6;4;5;14;14;37
905;6;11;13;13;5;42
906;6;9;17;10;12;48
907;6;13;14;15;17;59
908;6;7;15;7;12;41
909;6;10;9;7;12;38
910;6;7;13;14;13;47
911;6;11;16;21;11;59
912;6;7;11;15;12;45
913;6;10;8;14;12;44
914;6;8;11;10;18;47
915;6;9;11;16;8;44
916;7;28;22;23;31;104
917;7;19;15;28;24;86
918;7;17;25;24;15;81
919;7;13;20;29;22;84
920;7;12;22;19;18;71
921;7;28;14;24;20;86
922;7;17;21;16;16;70
923;7;13;25;20;23;81
924;7;19;21;22;15;77
925;7;14;15;22;19;70
926;7;20;17;13;18;68
927;7;19;21;20;11;71
928;7;15;21;10;11;57
929;7;16;18;16;18;68
930;7;11;15;15;17;58
931;7;15;11;17;15;58
932;7;13;10;21;11;55
933;7;11;19;17;19;66
934;7;10;17;22;11;60
935;7;14;23;19;13;69
936;7;14;9;12;14;49
937;7;16;17;9;17;59
938;7;19;13;9;15;56
939;7;10;14;8;10;42
940;7;17;5;17;19;58
941;7;7;6;10;11;34
942;7;9;13;16;17;55
943;7;9;19;17;25;70
944;7;19;7;7;14;47
945;7;13;11;17;13;54
946;7;9;19;11;14;53
947;7;8;12;17;12;49
948;7;13;13;16;18;60
949;7;15;17;17;11;60
950;7;12;9;12;15;48
951;7;12;17;26;6;61
952;7;8;18;10;13;49
953;7;10;10;10;16;46
954;7;11;7;18;11;47
955;7;7;11;16;6;40
956;7;11;14;14;12;51
957;7;16;16;9;14;55
958;7;13;15;14;11;53
959;7;9;12;12;11;44
960;7;7;5;15;10;37
961;7;10;14;14;6;44
962;7;10;21;14;13;58
963;7;12;7;8;15;42
964;7;10;14;12;10;46
965;7;11;16;15;14;56
966;7;8;5;13;12;38
967;7;11;6;17;15;49
968;7;8;10;12;8;38
969;7;14;12;16;13;55
970;7;9;14;12;19;54
971;7;7;20;11;11;49
972;7;13;14;10;9;46
973;7;14;10;11;9;44
974;7;5;13;12;10;40
975;7;9;5;14;11;39
976;7;11;5;14;8;38
977;7;9;17;16;10;52
978;7;10;9;9;14;42
979;7;9;14;8;14;45
980;7;11;9;6;12;38
981;7;14;10;5;14;43
982;7;8;13;6;11;38
983;7;11;12;9;15;47
984;7;8;15;12;12;47
985;7;9;17;20;17;63
986;7;11;6;14;5;36
987;7;8;7;12;11;38
988;7;13;12;4;9;38
989;7;12;13;11;11;47
990;7;7;9;13;6;35
991;7;14;13;19;4;50
992;7;11;8;12;14;45
993;7;4;8;12;14;38
994;7;9;14;15;13;51
995;7;12;7;10;8;37
996;7;17;6;13;15;51
997;7;15;9;8;11;43
998;7;8;11;10;12;41
999;7;8;11;9;11;39
1000;7;8;15;7;14;44
1001;7;11;12;14;11;48
1002;7;7;11;9;7;34
1003;7;7;8;14;9;38
1004;7;8;17;9;13;47
1005;7;8;8;13;8;37
1006;7;7;15;9;12;43
1007;7;4;12;15;5;36
1008;7;9;16;15;8;48
1009;7;7;12;9;4;32
1010;7;10;9;12;12;43
1011;7;11;12;12;9;44
1012;7;18;12;9;14;53
1013;7;6;9;9;7;31
1014;7;6;12;6;11;35
1015;7;10;12;15;11;48
1016;7;6;16;10;8;40
1017;7;11;14;11;6;42
1018;7;10;8;15;12;45
1019;7;5;12;12;9;38
1020;7;9;11;13;6;39
1021;7;6;17;13;6;42
1022;8;22;23;24;28;97
1023;8;27;22;18;15;82
1024;8;15;12;22;15;64
1025;8;25;22;18;16;81
1026;8;19;15;19;23;76
1027;8;19;19;19;19;76
1028;8;9;19;24;21;73
1029;8;11;22;26;24;83
1030;8;11;27;18;24;80
1031;8;10;18;18;13;59
1032;8;8;14;18;18;58
1033;8;13;12;18;17;60
1034;8;12;17;15;23;67
1035;8;12;21;21;18;72
1036;8;9;16;14;16;55
1037;8;12;15;13;7;47
1038;8;14;18;12;16;60
1039;8;14;6;9;17;46
1040;8;12;13;21;19;65
1041;8;10;22;9;11;52
1042;8;13;16;10;17;56
1043;8;10;8;18;12;48
1044;8;10;15;20;15;60
1045;8;7;19;12;16;54
1046;8;14;17;17;16;64
1047;8;8;18;22;18;66
1048;8;15;15;16;9;55
1049;8;11;16;12;8;47
1050;8;17;13;9;9;48
1051;8;13;14;20;16;63
1052;8;12;19;16;13;60
1053;8;10;15;14;14;53
1054;8;15;13;12;8;48
1055;8;7;7;13;16;43
1056;8;11;12;18;11;52
1057;8;10;15;16;6;47
1058;8;5;16;12;8;41
1059;8;8;10;13;9;40
1060;8;10;7;7;11;35
1061;8;12;13;14;16;55
1062;8;13;18;14;13;58
1063;8;7;10;16;12;45
1064;8;10;11;12;9;42
1065;8;15;11;9;11;46
1066;8;7;10;12;14;43
1067;8;14;11;10;9;44
1068;8;13;11;7;11;42
1069;8;10;9;14;10;43
1070;8;8;15;20;15;58
1071;8;8;15;13;6;42
1072;8;6;12;13;10;41
1073;8;7;15;13;9;44
1074;8;8;10;8;10;36
1075;8;7;17;9;12;45
1076;8;5;12;9;13;39
1077;8;7;14;14;21;56
1078;8;9;11;11;5;36
1079;8;11;18;13;3;45
1080;8;11;14;15;15;55
1081;8;7;9;8;8;32
1082;8;11;21;13;9;54
1083;8;7;11;9;13;40
1084;8;9;18;11;11;49
1085;8;10;9;13;10;42
1086;8;9;15;16;11;51
1087;8;11;11;15;15;52
1088;8;11;10;13;9;43
1089;8;7;15;12;6;40
1090;8;15;6;11;17;49
1091;8;9;18;16;10;53
1092;8;2;14;7;13;36
1093;8;9;10;15;6;40
1094;8;6;7;13;16;42
1095;8;16;10;11;11;48
1096;8;15;11;20;14;60
1097;8;9;10;18;15;52
1098;10;19;21;19;16;75
1099;10;19;16;22;18;75
1100;10;14;19;12;24;69
1101;10;9;19;24;11;63
1102;10;13;17;17;18;65
1103;10;19;21;14;14;68
1104;10;12;23;18;17;70
1105;10;14;20;18;22;74
1106;10;13;18;20;22;73
1107;10;5;12;11;15;43
1108;10;10;14;9;16;49
1109;10;11;10;17;14;52
1110;10;14;19;16;17;66
1111;10;16;16;17;13;62
1112;10;13;21;15;30;79
1113;10;14;21;16;18;69
1114;10;11;15;11;11;48
1115;10;9;11;15;12;47
1116;10;9;19;9;18;55
1117;10;6;14;16;16;52
1118;10;14;12;15;12;53
1119;10;13;12;20;15;60
1120;10;14;15;13;9;51
1121;10;7;16;9;14;46
1122;10;7;11;14;10;42
1123;10;11;12;10;10;43
1124;10;11;11;9;13;44
1125;10;14;13;15;15;57
1126;10;10;15;14;15;54
1127;10;3;11;7;13;34
1128;10;6;16;19;9;50
1129;10;8;7;9;16;40
1130;10;12;14;14;11;51
1131;10;11;13;9;21;54
1132;10;9;16;17;11;53
1133;10;5;14;13;14;46
1134;10;15;9;14;11;49
1135;10;8;11;9;11;39
1136;10;9;15;9;15;48
1137;10;16;11;13;13;53
1138;10;8;12;12;14;46
1139;10;13;11;13;10;47
1140;10;12;12;8;12;44
1141;10;7;13;9;7;36
1142;10;9;7;11;12;39
1143;10;7;8;11;13;39
1144;10;10;17;14;9;50
1145;10;11;13;12;15;51
1146;10;13;13;15;7;48
1147;10;11;13;10;6;40
1148;10;4;13;8;8;33
1149;10;11;12;12;12;47
1150;10;8;6;16;14;44
1151;10;11;13;10;12;46
1152;10;5;12;15;6;38
1153;10;10;10;11;11;42
1154;10;11;12;12;12;47
1155;10;7;14;13;6;40
1156;10;11;11;12;9;43
1157;10;16;11;14;9;50
1158;10;10;8;10;10;38
1159;10;8;9;10;9;36
1160;10;12;8;13;11;44
1161;10;7;15;7;9;38
1162;10;14;9;15;7;45
1163;10;16;13;10;7;46
1164;10;9;10;9;11;39
1165;10;7;9;12;19;47
1166;10;5;18;11;12;46
1167;10;6;13;6;9;34
1168;10;10;14;14;13;51
1169;10;7;9;7;8;31
1170;10;9;11;16;11;47
1171;10;13;11;12;14;50
1172;10;7;12;15;8;42
1173;10;10;13;11;11;45
1174;10;9;15;15;13;52
1175;10;7;12;10;7;36
1176;10;7;9;13;11;40
1177;10;5;8;4;8;25
1178;10;4;7;9;10;30
1179;10;7;11;12;13;43
1180;10;9;11;8;11;39
1181;10;4;10;8;14;36
1182;10;11;9;6;7;33
1183;10;9;11;16;12;48
1184;10;4;13;8;3;28
1185;10;4;9;8;6;27
1186;10;14;9;10;12;45
1187;10;11;9;8;9;37
1188;10;4;12;15;11;42
1189;10;14;8;11;13;46
1190;10;10;12;8;10;40
1191;10;12;7;10;14;43
1192;10;6;12;12;12;42
1193;10;6;17;8;7;38
1194;10;7;10;9;12;38
