t;tr;ch1;ch2;ch3;ch4;sum
0;0;1;4;3;4;12
1;0;6;1;4;3;14
2;0;1;4;1;4;10
3;0;23;2;7;4;36
4;0;4;5;3;3;15
5;0;9;5;3;4;21
6;0;2;5;2;2;11
7;0;5;3;2;3;13
8;0;4;4;1;1;10
9;0;3;6;1;4;14
10;0;0;3;4;3;10
11;0;1;4;0;7;12
12;0;3;2;1;4;10
13;0;1;2;3;4;10
14;0;2;5;3;5;15
15;0;2;6;8;1;17
16;0;4;2;3;5;14
17;0;3;4;1;3;11
18;0;0;1;6;1;8
19;0;3;4;5;4;16
20;0;4;5;4;1;14
21;0;0;1;4;4;9
22;0;5;2;1;3;11
23;0;3;2;4;4;13
24;0;3;6;1;3;13
25;0;2;3;2;5;12
26;0;6;3;4;2;15
27;0;4;2;2;4;12
28;0;1;3;1;2;7
29;0;4;5;2;2;13
30;0;0;4;2;2;8
31;0;3;3;5;3;14
32;0;4;0;2;7;13
33;0;1;1;5;4;11
34;0;3;4;6;0;13
35;0;0;2;2;3;7
36;0;6;3;3;4;16
37;0;2;1;4;4;11
38;0;1;5;0;3;9
39;0;1;3;4;2;10
40;0;3;5;4;4;16
41;0;2;4;3;4;13
42;0;3;1;5;3;12
43;0;1;4;3;3;11
44;0;4;2;6;2;14
45;0;3;4;3;1;11
46;0;1;2;3;3;9
47;0;2;1;5;4;12
48;0;4;5;3;1;13
49;0;5;1;3;5;14
50;0;1;3;3;5;12
51;0;6;1;3;4;14
52;0;4;3;5;5;17
53;0;4;1;2;4;11
54;0;2;5;2;4;13
55;0;3;2;5;2;12
56;0;3;5;2;2;12
57;0;3;5;4;2;14
58;0;5;4;2;4;15
59;0;3;1;4;2;10
60;0;2;5;1;8;16
61;0;3;1;4;0;8
62;0;4;2;5;5;16
63;0;3;4;3;1;11
64;0;3;4;4;3;14
65;0;2;2;5;2;11
66;0;3;5;0;2;10
67;0;2;2;3;2;9
68;0;0;2;7;0;9
69;0;3;3;7;4;17
70;0;3;2;4;1;10
71;0;3;3;5;4;15
72;0;5;1;3;3;12
73;0;2;1;2;4;9
74;0;4;4;5;1;14
75;0;4;1;5;2;12
76;0;6;3;4;3;16
77;0;0;5;3;2;10
78;0;4;1;1;5;11
79;0;6;1;2;6;15
80;0;6;6;2;2;16
81;0;1;3;2;1;7
82;0;4;2;8;1;15
83;0;7;5;2;3;17
84;0;3;3;2;3;11
85;0;2;8;8;2;20
86;0;1;4;3;2;10
87;0;3;2;2;1;8
88;0;4;4;3;2;13
89;0;1;3;2;3;9
90;0;5;2;3;4;14
91;0;1;3;3;3;10
92;0;3;2;2;2;9
93;0;1;8;2;6;17
94;0;2;5;0;4;11
95;0;2;2;3;4;11
96;0;3;5;3;3;14
97;0;4;2;3;4;13
98;0;3;5;2;2;12
99;0;3;1;4;0;8
100;0;3;4;7;7;21
101;0;4;4;1;4;13
102;0;6;3;3;4;16
103;0;3;5;3;2;13
104;0;4;4;2;5;15
105;0;4;1;8;2;15
106;0;5;2;2;4;13
107;0;4;4;5;4;17
108;0;1;4;2;4;11
109;0;2;3;0;1;6
110;0;3;4;2;1;10
111;0;3;1;8;2;14
112;0;3;3;6;6;18
113;0;5;5;2;5;17
114;0;0;7;3;3;13
115;0;8;3;5;2;18
116;0;2;4;3;1;10
117;0;4;1;1;5;11
118;0;2;1;3;4;10
119;0;4;2;2;3;11
120;0;5;2;3;4;14
121;0;5;2;2;2;11
122;0;7;2;3;3;15
123;0;2;2;5;4;13
124;0;3;4;3;3;13
125;0;0;4;0;2;6
126;0;4;3;2;2;11
127;0;4;4;2;3;13
128;0;0;4;3;2;9
129;0;4;4;2;3;13
130;0;6;9;4;6;25
131;0;3;8;2;5;18
132;0;4;2;4;5;15
133;0;3;4;3;1;11
134;0;1;2;4;1;8
135;0;1;4;2;5;12
136;0;2;2;4;2;10
137;0;2;5;2;3;12
138;0;4;3;5;4;16
139;0;6;3;2;1;12
140;0;3;3;4;4;14
141;0;2;5;0;3;10
142;0;8;6;1;3;18
143;0;3;3;1;1;8
144;0;0;2;7;3;12
145;0;2;3;7;4;16
146;0;1;2;6;4;13
147;0;2;2;2;2;8
148;0;4;3;5;4;16
149;0;4;3;3;3;13
150;0;0;2;4;1;7
151;0;0;4;1;4;9
152;0;5;1;2;3;11
153;0;2;5;6;0;13
154;0;3;5;6;4;18
155;0;3;2;3;3;11
156;0;1;3;3;2;9
157;0;9;4;4;5;22
158;0;2;2;1;1;6
159;0;4;5;1;2;12
160;0;1;7;2;1;11
161;0;2;4;4;5;15
162;0;2;2;5;7;16
163;0;3;2;3;1;9
164;0;1;4;2;4;11
165;0;2;2;3;4;11
166;0;2;3;2;1;8
167;0;0;1;4;4;9
168;0;5;3;3;4;15
169;0;1;5;6;3;15
170;0;3;2;2;5;12
171;0;2;3;7;4;16
172;0;3;3;4;3;13
173;0;2;5;0;2;9
174;0;1;1;6;2;10
175;0;1;0;2;3;6
176;0;2;2;1;2;7
177;0;2;4;2;3;11
178;0;1;0;2;4;7
179;0;2;1;3;3;9
180;0;1;3;5;0;9
181;0;3;5;6;3;17
182;0;0;0;4;3;7
183;0;4;1;2;4;11
184;0;5;5;4;5;19
185;0;3;3;2;3;11
186;0;1;3;2;3;9
187;0;1;3;3;4;11
188;0;3;5;3;7;18
189;0;5;2;6;5;18
190;0;2;4;4;6;16
191;0;3;1;6;8;18
192;0;4;3;2;2;11
193;0;5;1;5;3;14
194;0;3;6;7;6;22
195;0;0;2;3;3;8
196;0;1;3;4;2;10
197;0;2;4;3;6;15
198;0;2;3;3;5;13
199;0;5;4;2;3;14
200;0;6;2;5;4;17
201;0;4;4;2;6;16
202;0;1;2;9;1;13
203;0;4;5;1;0;10
204;0;5;4;1;4;14
205;0;3;2;3;4;12
206;0;3;1;7;1;12
207;0;4;3;3;3;13
208;0;2;2;1;6;11
209;0;3;3;2;7;15
210;0;5;1;3;3;12
211;0;0;3;1;2;6
212;0;2;4;1;4;11
213;0;2;3;4;2;11
214;0;3;2;3;1;9
215;0;3;4;2;2;11
216;0;1;1;2;2;6
217;0;22;13;15;20;70
218;0;1;3;2;1;7
219;0;3;2;5;2;12
220;0;1;4;4;5;14
221;0;3;2;1;5;11
222;0;0;2;6;3;11
223;0;3;5;5;3;16
224;0;1;3;4;3;11
225;0;3;1;5;3;12
226;0;4;2;5;3;14
227;0;3;3;4;3;13
228;0;7;1;3;1;12
229;0;0;3;3;4;10
230;0;2;3;4;5;14
231;0;1;4;4;4;13
232;0;5;3;5;8;21
233;0;5;5;3;6;19
234;0;3;3;1;3;10
235;0;2;2;3;2;9
236;0;6;4;3;4;17
237;0;1;2;1;4;8
238;0;2;3;3;4;12
239;0;5;1;6;1;13
240;0;2;3;3;1;9
241;0;5;1;2;0;8
242;0;5;2;3;1;11
243;0;6;1;5;2;14
244;0;6;3;1;2;12
245;0;3;2;3;2;10
246;0;2;3;1;7;13
247;0;5;3;5;2;15
248;0;1;2;9;2;14
249;0;5;7;3;4;19
250;0;5;3;2;3;13
251;0;3;1;3;0;7
252;0;2;2;1;2;7
253;0;1;5;6;5;17
254;0;3;4;3;4;14
255;0;2;2;6;4;14
256;0;3;5;4;1;13
257;0;2;3;3;2;10
258;0;4;4;1;4;13
259;0;2;3;5;2;12
260;0;4;4;4;6;18
261;0;0;2;2;4;8
262;0;2;0;2;4;8
263;0;2;3;3;2;10
264;0;5;0;2;0;7
265;0;3;0;3;2;8
266;0;0;3;2;3;8
267;0;2;2;6;4;14
268;0;2;3;4;4;13
269;0;3;5;2;2;12
270;0;3;2;2;4;11
271;0;0;7;1;1;9
272;0;0;3;7;2;12
273;0;0;4;4;6;14
274;0;1;2;3;5;11
275;0;3;2;0;2;7
276;0;2;2;5;2;11
277;0;1;3;1;3;8
278;0;5;2;8;4;19
279;0;5;1;6;3;15
280;0;2;0;4;8;14
281;0;3;5;2;1;11
282;0;5;4;3;4;16
283;0;1;3;0;0;4
284;0;1;4;5;6;16
285;0;4;3;3;3;13
286;0;3;5;3;7;18
287;0;1;3;1;4;9
288;0;5;4;5;5;19
289;0;6;5;3;2;16
290;0;6;3;4;2;15
291;0;2;2;1;6;11
292;0;5;3;3;2;13
293;0;2;2;7;2;13
294;0;0;2;4;5;11
295;0;2;4;5;2;13
296;0;2;3;6;3;14
297;0;2;2;4;0;8
298;0;2;2;2;2;8
299;0;1;1;2;4;8
300;0;1;1;4;2;8
301;0;1;3;3;6;13
302;0;2;5;2;5;14
303;0;2;3;8;3;16
304;0;3;2;3;1;9
305;0;4;7;4;1;16
306;0;3;1;3;4;11
307;0;4;3;2;8;17
308;0;1;1;1;5;8
309;0;3;5;1;2;11
310;0;6;6;2;5;19
311;0;3;1;3;4;11
312;0;4;2;1;2;9
313;0;2;9;4;3;18
314;0;2;3;3;3;11
315;0;2;4;3;6;15
316;0;4;3;3;3;13
317;0;3;3;2;2;10
318;0;2;3;0;3;8
319;0;3;3;5;4;15
320;0;1;3;1;3;8
321;0;3;2;5;4;14
322;0;3;8;2;4;17
323;0;3;1;1;4;9
324;0;4;4;2;4;14
325;0;2;5;5;5;17
326;0;0;5;3;2;10
327;0;4;4;4;2;14
328;0;2;5;2;3;12
329;0;2;1;1;2;6
330;0;4;3;1;6;14
331;0;3;5;1;3;12
332;0;1;4;2;2;9
333;0;5;8;1;0;14
334;0;2;0;3;6;11
335;0;2;0;2;2;6
336;0;4;5;7;5;21
337;0;4;6;3;0;13
338;0;3;3;6;1;13
339;0;2;5;2;2;11
340;0;5;7;6;2;20
341;0;3;3;6;0;12
342;0;3;3;6;2;14
343;0;4;1;5;6;16
344;0;0;3;5;3;11
345;0;3;4;6;0;13
346;0;1;1;1;3;6
347;0;4;4;4;3;15
348;0;5;2;2;3;12
349;0;2;0;6;2;10
350;0;7;1;4;3;15
351;0;2;1;3;3;9
352;0;4;2;2;1;9
353;0;3;4;3;3;13
354;0;4;4;2;5;15
355;0;1;3;4;10;18
356;0;2;4;3;5;14
357;0;4;3;4;3;14
358;0;5;4;2;2;13
359;0;7;1;4;3;15
360;0;7;1;6;1;15
361;0;5;5;3;3;16
362;0;2;3;6;3;14
363;0;2;2;1;4;9
364;0;2;9;2;3;16
365;0;3;0;3;2;8
366;0;2;1;7;4;14
367;0;4;4;3;2;13
368;0;3;5;5;6;19
369;0;4;2;2;2;10
370;0;2;1;6;4;13
371;0;4;2;2;3;11
372;0;3;1;3;3;10
373;0;5;6;2;4;17
374;0;1;2;1;5;9
375;0;2;2;0;2;6
376;0;2;2;2;2;8
377;0;4;2;0;3;9
378;0;1;5;2;3;11
379;0;2;2;4;1;9
380;0;1;4;5;2;12
381;0;0;4;2;0;6
382;0;1;4;3;1;9
383;0;0;3;4;1;8
384;0;7;4;4;3;18
385;0;3;3;5;4;15
386;0;0;4;5;4;13
387;0;3;2;4;1;10
388;0;2;1;1;3;7
389;0;4;4;5;4;17
390;0;4;3;2;2;11
391;0;1;3;1;3;8
392;0;3;4;1;3;11
393;0;6;3;4;8;21
394;0;2;5;7;3;17
395;0;2;3;2;2;9
396;0;2;4;4;1;11
397;0;2;5;4;2;13
398;0;3;3;6;1;13
399;0;2;5;4;2;13
400;0;1;1;1;3;6
401;0;1;1;2;3;7
402;0;5;0;7;1;13
403;0;4;7;1;1;13
404;0;3;4;2;0;9
405;0;3;4;3;1;11
406;0;3;3;3;2;11
407;0;2;6;3;5;16
408;0;4;2;2;2;10
409;0;3;0;3;4;10
410;0;2;1;6;5;14
411;0;0;4;4;2;10
412;0;4;0;2;4;10
413;0;7;3;4;5;19
414;0;3;4;5;4;16
415;0;3;4;3;5;15
416;0;2;1;0;3;6
417;0;2;5;7;1;15
418;0;4;5;1;3;13
419;0;0;2;6;4;12
420;0;3;3;6;1;13
421;0;2;2;6;5;15
422;0;1;1;6;1;9
423;0;2;3;6;3;14
424;0;3;3;2;1;9
425;0;0;5;4;6;15
426;0;4;2;3;3;12
427;0;2;0;8;3;13
428;0;6;4;3;6;19
429;0;3;7;3;2;15
430;0;2;2;3;0;7
431;0;2;3;2;5;12
432;0;4;3;4;5;16
433;0;3;2;3;6;14
434;0;4;3;3;3;13
435;0;4;2;2;4;12
436;0;1;3;6;3;13
437;0;3;3;2;2;10
438;0;2;3;2;4;11
439;0;4;3;5;2;14
440;0;8;6;4;2;20
441;0;1;3;1;2;7
442;0;3;5;2;2;12
443;0;3;7;4;6;20
444;0;1;6;7;4;18
445;0;2;2;2;0;6
446;0;2;4;3;6;15
447;0;3;6;5;1;15
448;0;7;2;4;5;18
449;0;3;3;1;5;12
450;0;1;2;2;1;6
451;0;3;3;3;1;10
452;0;4;4;3;0;11
453;0;4;1;3;2;10
454;0;5;4;1;0;10
455;0;2;2;5;2;11
456;0;5;2;1;4;12
457;0;9;7;1;2;19
458;0;3;2;0;5;10
459;0;2;3;6;3;14
460;0;3;5;1;4;13
461;0;0;4;6;2;12
462;0;1;7;5;2;15
463;0;3;3;1;0;7
464;0;0;7;1;2;10
465;0;3;3;3;2;11
466;0;7;2;5;4;18
467;0;0;0;1;3;4
468;0;5;3;4;2;14
469;0;4;3;5;4;16
470;0;2;1;1;1;5
471;0;5;5;2;4;16
472;0;5;1;4;1;11
473;0;5;6;6;0;17
474;0;5;0;0;6;11
475;0;4;2;3;5;14
476;0;2;2;3;2;9
477;0;2;2;3;1;8
478;0;3;8;1;2;14
479;0;3;2;8;0;13
480;0;3;2;4;3;12
481;0;3;1;3;3;10
482;0;3;2;2;2;9
483;0;3;1;5;4;13
484;0;1;3;7;4;15
485;0;4;4;4;2;14
486;0;1;5;4;1;11
487;0;5;5;4;4;18
488;0;1;4;8;4;17
489;0;2;4;1;4;11
490;0;0;4;5;7;16
491;0;0;6;2;1;9
492;0;3;1;2;0;6
493;0;2;3;5;1;11
494;0;2;3;3;3;11
495;0;2;5;4;1;12
496;0;3;0;2;2;7
497;0;4;3;3;3;13
498;0;2;1;2;1;6
499;0;5;2;6;4;17
500;0;2;2;5;7;16
501;0;1;1;2;3;7
502;0;6;2;3;2;13
503;0;4;4;3;2;13
504;0;0;2;3;1;6
505;0;3;2;2;6;13
506;0;3;5;4;0;12
507;0;3;3;4;6;16
508;0;3;4;5;5;17
509;0;4;2;5;2;13
510;0;2;5;4;4;15
511;0;3;3;4;3;13
512;0;0;2;1;3;6
513;0;2;4;4;2;12
514;0;4;3;5;2;14
515;0;1;2;4;2;9
516;0;2;1;1;3;7
517;0;4;4;5;6;19
518;0;3;5;3;2;13
519;0;4;4;5;1;14
520;0;4;2;5;3;14
521;0;2;3;2;2;9
522;0;2;3;2;3;10
523;0;4;3;3;1;11
524;0;3;2;5;5;15
525;0;2;3;3;2;10
526;0;4;2;6;5;17
527;0;3;3;4;1;11
528;0;2;2;4;3;11
529;0;3;3;3;1;10
530;0;8;4;3;1;16
531;0;3;4;3;3;13
532;0;2;9;3;4;18
533;0;0;2;0;4;6
534;0;9;1;3;1;14
535;0;3;7;3;0;13
536;0;1;5;4;3;13
537;0;3;8;1;3;15
538;0;0;1;1;1;3
539;0;1;2;2;6;11
540;0;1;2;5;2;10
541;0;7;5;3;2;17
542;0;4;2;3;9;18
543;0;4;5;4;4;17
544;0;7;2;4;2;15
545;0;1;1;4;2;8
546;0;2;0;4;2;8
547;0;1;2;4;3;10
548;0;1;2;2;2;7
549;0;4;3;6;2;15
550;0;3;5;4;3;15
551;0;4;2;3;3;12
552;0;5;7;1;6;19
553;0;2;2;3;5;12
554;0;6;6;2;3;17
555;0;2;4;3;3;12
556;0;1;2;4;5;12
557;0;3;0;5;2;10
558;0;5;1;1;4;11
559;0;4;1;4;4;13
560;0;4;2;3;1;10
561;0;4;0;0;1;5
562;0;2;6;8;2;18
563;0;4;6;5;3;18
564;0;2;3;2;4;11
565;0;3;2;1;1;7
566;0;0;4;3;2;9
567;0;2;4;2;2;10
568;0;1;3;5;3;12
569;0;2;2;3;2;9
570;0;0;3;3;2;8
571;0;2;2;2;1;7
572;0;6;3;4;1;14
573;0;2;2;2;3;9
574;0;3;2;1;4;10
575;0;2;5;1;4;12
576;0;2;4;2;4;12
577;0;6;2;2;4;14
578;0;3;3;4;1;11
579;0;0;1;2;3;6
580;0;2;5;1;5;13
581;0;4;3;3;5;15
582;0;3;2;2;7;14
583;0;3;3;1;3;10
584;0;2;8;5;1;16
585;0;1;1;1;2;5
586;0;2;3;3;3;11
587;0;2;2;7;5;16
588;0;2;1;5;4;12
589;0;1;1;2;2;6
590;0;7;2;1;3;13
591;0;3;1;1;1;6
592;0;2;4;7;3;16
593;0;1;1;6;2;10
594;0;1;6;2;1;10
595;0;5;3;4;3;15
596;0;1;4;4;4;13
597;0;2;1;6;3;12
598;0;4;2;2;3;11
599;0;2;2;2;2;8
600;0;4;1;4;5;14
601;0;5;1;6;3;15
602;0;2;4;2;4;12
603;0;3;3;3;3;12
604;0;0;3;1;2;6
605;0;4;3;3;4;14
606;0;1;3;4;4;12
607;0;3;5;4;5;17
608;0;2;3;3;3;11
609;0;6;2;2;1;11
610;0;6;5;4;4;19
611;0;3;5;2;3;13
612;0;4;2;2;0;8
613;0;4;6;2;0;12
614;0;3;6;6;2;17
615;0;0;3;2;0;5
616;0;1;2;3;3;9
617;0;3;1;5;5;14
618;0;2;4;7;4;17
619;0;4;3;4;3;14
620;0;3;0;5;4;12
621;0;5;1;5;3;14
622;0;4;1;1;1;7
623;0;1;2;3;4;10
624;0;3;7;5;7;22
625;0;1;7;2;3;13
626;0;0;2;4;3;9
627;0;1;1;3;7;12
628;0;3;4;9;6;22
629;0;1;1;2;1;5
630;0;1;4;5;5;15
631;0;1;4;5;1;11
632;0;4;5;5;2;16
633;0;6;2;4;2;14
634;0;3;3;6;2;14
635;0;1;2;1;0;4
636;0;0;3;5;1;9
637;0;1;4;1;4;10
638;0;2;2;6;4;14
639;0;5;2;6;2;15
640;0;2;6;2;1;11
641;0;5;0;5;4;14
642;0;5;1;3;4;13
643;0;2;2;1;3;8
644;0;5;5;3;3;16
645;0;0;3;4;2;9
646;0;4;2;3;3;12
647;0;4;2;3;0;9
648;0;2;3;3;3;11
649;0;5;3;2;4;14
650;0;2;1;5;3;11
651;0;6;3;1;2;12
652;0;4;5;5;3;17
653;0;7;4;3;2;16
654;0;0;7;7;2;16
655;0;1;4;3;4;12
656;0;5;3;2;0;10
657;0;5;1;4;3;13
658;0;3;2;4;3;12
659;0;3;5;3;3;14
660;0;3;0;1;2;6
661;0;3;1;2;2;8
662;0;1;1;1;3;6
663;0;4;2;2;4;12
664;0;0;3;7;3;13
665;0;2;5;3;5;15
666;0;2;3;3;5;13
667;0;6;3;1;5;15
668;0;1;1;3;4;9
669;0;6;6;3;2;17
670;0;4;1;3;2;10
671;0;4;1;2;2;9
672;0;2;2;4;3;11
673;0;1;2;4;1;8
674;0;3;3;4;1;11
675;0;4;1;3;6;14
676;0;3;2;4;6;15
677;0;0;4;3;0;7
678;0;5;8;4;4;21
679;0;6;3;2;4;15
680;0;1;1;6;5;13
681;0;4;3;1;4;12
682;0;1;1;1;4;7
683;0;3;7;4;5;19
684;0;3;6;4;4;17
685;0;0;7;3;3;13
686;0;2;2;2;4;10
687;0;3;3;4;5;15
688;0;1;3;2;5;11
689;0;3;2;4;2;11
690;0;1;2;2;3;8
691;0;1;2;2;1;6
692;0;3;3;3;2;11
693;0;4;1;0;2;7
694;0;4;3;3;4;14
695;0;5;6;4;2;17
696;0;4;3;8;1;16
697;0;2;6;2;5;15
698;0;4;2;4;2;12
699;0;0;4;3;5;12
700;0;4;3;0;0;7
701;0;0;2;2;3;7
702;0;4;1;4;5;14
703;0;0;3;5;3;11
704;0;3;2;4;1;10
705;0;5;4;2;5;16
706;0;6;2;0;3;11
707;0;4;3;5;3;15
708;0;3;1;2;2;8
709;0;3;1;2;6;12
710;0;3;9;2;5;19
711;0;6;3;2;2;13
712;0;4;2;7;2;15
713;0;1;2;1;1;5
714;0;4;4;3;2;13
715;0;5;6;1;3;15
716;0;3;4;1;0;8
717;0;3;3;6;5;17
718;0;4;4;4;2;14
719;0;2;1;4;5;12
720;0;0;0;2;3;5
721;0;4;3;5;3;15
722;0;5;1;4;4;14
723;0;2;1;1;3;7
724;0;3;2;5;1;11
725;0;2;4;5;4;15
726;0;4;1;3;2;10
727;0;4;4;4;4;16
728;2;426;479;454;428;1787
729;2;398;416;391;406;1611
730;2;361;397;368;362;1488
731;2;326;380;391;353;1450
732;2;335;369;325;343;1372
733;2;324;352;345;330;1351
734;2;312;341;317;344;1314
735;2;285;302;332;305;1224
736;2;276;305;304;287;1172
737;2;222;311;246;279;1058
738;2;218;272;250;249;989
739;2;230;260;272;260;1022
740;2;228;248;230;204;910
741;2;215;244;255;222;936
742;2;204;246;211;223;884
743;2;188;204;223;186;801
744;2;184;206;193;187;770
745;2;198;236;219;163;816
746;2;161;189;182;179;711
747;2;151;179;178;152;660
748;2;174;174;172;173;693
749;2;160;181;171;175;687
750;2;127;149;146;157;579
751;2;139;163;148;152;602
752;2;148;154;146;140;588
753;2;127;128;136;135;526
754;2;122;114;144;129;509
755;2;133;124;137;135;529
756;2;104;106;141;129;480
757;2;96;97;108;122;423
758;2;90;122;93;114;419
759;2;96;107;98;99;400
760;2;96;106;86;85;373
761;2;70;88;78;93;329
762;2;74;68;96;82;320
763;2;75;96;94;80;345
764;2;73;80;82;84;319
765;2;90;81;82;91;344
766;2;67;71;66;77;281
767;2;71;79;67;59;276
768;2;68;81;65;75;289
769;2;48;47;56;68;219
770;2;61;74;55;78;268
771;2;53;62;77;49;241
772;2;42;56;53;64;215
773;2;55;59;53;46;213
774;2;40;50;51;45;186
775;2;37;54;63;62;216
776;2;35;42;46;61;184
777;2;41;56;54;40;191
778;2;35;36;47;37;155
779;2;37;28;37;31;133
780;2;43;55;53;49;200
781;2;40;43;46;45;174
782;2;33;31;37;35;136
783;2;30;46;46;33;155
784;2;27;44;33;22;126
785;2;38;34;32;17;121
786;2;30;23;27;25;105
787;2;27;22;31;35;115
788;2;31;35;30;29;125
789;2;24;29;34;24;111
790;2;20;24;24;26;94
791;2;19;25;33;18;95
792;2;25;27;23;29;104
793;2;20;39;26;21;106
794;2;18;24;26;23;91
795;2;19;28;21;21;89
796;2;20;24;20;22;86
797;2;27;26;18;18;89
798;2;20;18;19;22;79
799;2;8;26;23;24;81
800;2;18;25;28;18;89
801;2;14;13;18;11;56
802;2;12;18;12;16;58
803;2;15;10;18;17;60
804;2;12;6;11;16;45
805;2;16;10;18;14;58
806;2;12;14;28;19;73
807;2;11;8;15;14;48
808;2;11;11;8;19;49
809;2;7;16;14;14;51
810;2;14;9;10;11;44
811;2;9;15;19;12;55
812;2;13;16;9;7;45
813;2;9;14;10;16;49
814;2;11;16;14;8;49
815;2;8;15;10;5;38
816;2;5;10;14;5;34
817;2;5;11;10;15;41
818;2;10;9;9;13;41
819;2;4;11;11;9;35
820;2;8;16;7;11;42
821;2;8;9;10;8;35
822;2;5;8;10;6;29
823;2;5;8;12;9;34
824;2;7;11;9;3;30
825;2;8;6;8;9;31
826;2;9;10;6;7;32
827;2;7;9;6;6;28
828;2;6;9;7;8;30
829;2;5;9;8;8;30
830;2;5;7;11;6;29
831;2;7;9;9;12;37
832;2;5;12;8;8;33
833;2;2;5;8;2;17
834;2;5;9;10;6;30
835;2;6;4;6;10;26
836;2;3;5;2;8;18
837;2;5;3;13;9;30
838;2;5;9;9;10;33
839;2;9;8;6;5;28
840;2;8;6;8;8;30
841;2;9;7;5;8;29
842;2;5;5;13;12;35
843;2;2;8;6;5;21
844;2;5;7;6;4;22
845;2;4;10;7;3;24
846;2;5;5;7;6;23
847;2;5;15;4;6;30
848;2;5;8;6;6;25
849;2;4;6;4;4;18
850;2;7;5;7;6;25
851;2;3;3;4;8;18
852;2;6;8;8;5;27
853;2;6;5;6;7;24
854;2;4;3;8;4;19
855;2;4;3;6;7;20
856;2;8;4;6;8;26
857;2;5;7;2;6;20
858;2;2;5;2;5;14
859;2;6;2;5;5;18
860;2;9;10;1;3;23
861;2;5;10;2;5;22
862;2;4;3;8;3;18
863;2;8;4;8;7;27
864;2;2;3;8;0;13
865;2;2;1;4;2;9
866;2;1;9;11;5;26
867;2;7;3;6;4;20
868;2;2;2;4;2;10
869;2;3;11;4;6;24
870;2;1;7;6;4;18
871;2;3;4;9;6;22
872;2;5;4;4;3;16
873;2;4;6;6;2;18
874;2;0;5;2;7;14
875;2;2;6;4;6;18
876;2;6;6;3;2;17
877;2;7;7;6;6;26
878;2;1;6;3;6;16
879;2;0;0;5;5;10
880;2;2;4;9;6;21
881;2;4;3;4;3;14
882;2;4;8;3;5;20
883;2;1;3;4;1;9
884;2;4;5;7;7;23
885;2;5;6;7;3;21
886;2;5;7;6;1;19
887;2;6;1;3;3;13
888;2;3;7;3;4;17
889;2;6;2;7;4;19
890;2;5;2;7;8;22
891;2;4;2;4;1;11
892;2;4;3;3;1;11
893;2;4;3;1;3;11
894;2;5;2;5;2;14
895;2;2;6;6;5;19
896;2;3;7;4;6;20
897;2;4;3;3;8;18
898;2;5;2;5;5;17
899;2;2;3;5;6;16
900;2;2;3;4;5;14
901;2;4;1;9;6;20
902;2;0;5;5;3;13
903;2;6;5;4;5;20
904;2;6;3;5;7;21
905;2;2;5;7;6;20
906;2;3;1;7;8;19
907;2;3;5;6;5;19
908;2;4;4;2;1;11
909;2;2;1;2;3;8
910;2;2;4;3;9;18
911;2;4;7;5;3;19
912;2;4;2;4;7;17
913;2;3;5;1;7;16
914;2;8;8;6;2;24
915;2;3;4;8;6;21
916;2;3;5;4;7;19
917;2;5;0;6;1;12
918;2;4;4;3;3;14
919;2;3;4;4;1;12
920;2;3;8;4;5;20
921;2;6;5;6;4;21
922;2;6;5;8;7;26
923;2;4;1;1;3;9
924;2;4;6;4;3;17
925;2;3;5;4;3;15
926;2;4;3;1;7;15
927;2;3;6;3;2;14
928;2;3;0;4;3;10
929;2;3;4;5;2;14
930;2;3;3;7;5;18
931;2;3;3;7;2;15
932;2;2;3;4;3;12
933;2;3;3;4;6;16
934;2;3;4;2;6;15
935;2;5;2;7;6;20
936;2;0;3;6;1;10
937;2;6;3;2;5;16
938;2;4;10;1;4;19
939;2;5;8;5;10;28
940;2;6;5;5;3;19
941;2;2;5;6;3;16
942;2;7;7;3;4;21
943;2;5;6;6;6;23
944;2;4;3;2;6;15
945;2;7;1;3;8;19
946;2;3;5;2;4;14
947;2;3;8;4;2;17
948;2;4;7;5;8;24
949;2;3;5;8;6;22
950;2;2;1;1;2;6
951;2;4;4;6;5;19
952;2;5;6;2;3;16
953;2;5;3;1;4;13
954;2;4;5;4;2;15
955;2;4;6;4;2;16
956;2;3;2;1;2;8
957;2;4;3;3;2;12
958;2;5;7;3;5;20
959;2;4;5;4;3;16
960;2;4;2;5;3;14
961;2;4;8;4;1;17
962;2;5;7;7;2;21
963;2;4;8;7;4;23
964;2;8;4;4;3;19
965;2;6;2;4;4;16
966;2;1;4;4;6;15
967;2;6;3;3;2;14
968;2;3;6;6;6;21
969;2;6;6;4;4;20
970;2;2;3;4;7;16
971;2;2;2;5;6;15
972;2;4;5;2;7;18
973;2;2;6;5;1;14
974;2;4;3;4;5;16
975;2;6;5;3;2;16
976;2;3;3;6;6;18
977;2;4;5;3;5;17
978;2;5;5;8;3;21
979;2;1;8;8;6;23
980;2;8;5;4;1;18
981;2;2;7;5;2;16
982;2;2;3;3;7;15
983;2;10;3;3;6;22
984;2;2;2;4;1;9
985;2;3;3;3;4;13
986;2;3;4;4;6;17
987;2;3;7;1;4;15
988;2;1;5;1;2;9
989;2;2;1;3;4;10
990;2;2;4;1;4;11
991;2;3;6;3;2;14
992;2;8;6;2;2;18
993;2;3;6;3;7;19
994;2;5;5;5;6;21
995;2;5;2;4;6;17
996;2;3;5;2;5;15
997;2;5;7;3;4;19
998;2;7;2;6;5;20
999;2;5;7;8;6;26
1000;2;4;2;7;6;19
1001;2;5;4;5;3;17
1002;2;4;3;5;2;14
1003;2;3;2;3;3;11
1004;2;5;4;3;6;18
1005;2;10;3;3;3;19
1006;2;3;3;5;4;15
1007;2;3;4;7;2;16
1008;2;2;2;3;4;11
1009;2;5;7;4;4;20
1010;2;4;5;5;4;18
1011;2;6;8;5;7;26
1012;2;2;3;3;9;17
1013;2;4;6;6;1;17
1014;2;3;5;5;4;17
1015;2;4;3;4;1;12
1016;2;7;4;2;6;19
1017;2;5;7;6;2;20
1018;2;2;2;9;4;17
1019;2;4;2;7;3;16
1020;2;3;7;6;7;23
1021;2;4;5;6;3;18
1022;2;2;3;4;4;13
1023;2;5;4;2;5;16
1024;2;5;7;4;8;24
1025;2;6;2;6;6;20
1026;2;6;5;4;4;19
1027;2;1;5;6;3;15
1028;2;2;4;4;2;12
1029;2;5;7;1;3;16
1030;2;4;4;3;4;15
1031;2;2;5;3;8;18
1032;2;6;6;2;10;24
1033;2;5;2;3;4;14
1034;2;4;4;7;5;20
1035;2;4;6;6;1;17
1036;2;3;4;5;4;16
1037;2;1;4;4;4;13
1038;2;3;2;3;5;13
1039;2;1;5;5;5;16
1040;2;2;3;1;5;11
1041;2;4;4;2;2;12
1042;2;1;1;2;6;10
1043;2;7;3;7;5;22
1044;2;4;5;2;3;14
1045;2;2;5;5;4;16
1046;2;4;5;5;2;16
1047;2;1;1;6;3;11
1048;2;2;6;1;1;10
1049;2;1;2;8;6;17
1050;2;2;2;1;7;12
1051;2;3;1;5;5;14
1052;2;3;3;3;3;12
1053;2;4;4;4;2;14
1054;2;5;3;4;4;16
1055;2;6;5;2;3;16
1056;2;4;9;5;4;22
1057;2;5;2;5;4;16
1058;2;3;6;3;5;17
1059;2;3;5;6;6;20
1060;2;3;3;7;8;21
1061;2;2;3;6;8;19
1062;2;3;4;1;5;13
1063;2;4;4;6;6;20
1064;2;3;5;5;2;15
1065;2;3;3;2;4;12
1066;2;0;8;2;4;14
1067;2;2;5;0;3;10
1068;2;8;6;1;9;24
1069;2;1;4;5;3;13
1070;2;6;3;7;1;17
1071;2;4;4;8;6;22
1072;2;2;4;4;1;11
1073;2;1;5;3;2;11
1074;2;8;4;3;5;20
1075;2;7;4;4;9;24
1076;2;5;6;9;4;24
1077;2;1;4;3;4;12
1078;2;3;5;5;6;19
1079;2;3;3;3;1;10
1080;2;2;5;2;4;13
1081;2;5;2;7;4;18
1082;2;1;4;7;6;18
1083;2;2;6;2;4;14
1084;2;5;6;1;10;22
1085;2;4;3;7;3;17
1086;2;2;7;2;4;15
1087;2;4;6;3;5;18
1088;2;2;3;3;5;13
1089;2;3;3;6;5;17
1090;2;2;2;7;5;16
1091;2;2;4;2;5;13
1092;2;3;5;3;4;15
1093;2;3;5;4;4;16
1094;2;5;4;5;3;17
1095;2;1;4;5;4;14
1096;2;7;2;5;2;16
1097;2;1;1;3;6;11
1098;2;1;4;2;1;8
1099;2;4;1;3;5;13
1100;2;5;2;4;3;14
1101;2;2;5;3;2;12
1102;2;3;5;4;2;14
1103;2;5;4;1;3;13
1104;2;1;4;8;2;15
1105;2;1;6;5;2;14
1106;2;8;3;7;1;19
1107;2;7;3;6;3;19
1108;2;4;3;5;4;16
1109;2;6;5;7;3;21
1110;2;1;3;5;5;14
1111;2;2;3;1;4;10
1112;2;8;0;6;5;19
1113;2;2;3;0;6;11
1114;2;0;4;4;1;9
1115;2;6;4;5;5;20
1116;2;6;6;2;6;20
1117;2;5;3;4;5;17
1118;2;7;5;5;4;21
1119;2;5;6;4;7;22
1120;2;1;2;2;8;13
1121;2;3;2;5;1;11
1122;2;8;4;6;3;21
1123;2;7;4;5;6;22
1124;2;5;8;2;5;20
1125;2;3;2;2;3;10
1126;2;5;2;6;4;17
1127;2;3;0;2;5;10
1128;2;3;4;4;2;13
1129;2;3;1;4;3;11
1130;2;3;4;1;2;10
1131;4;206;206;219;192;823
1132;4;172;182;195;192;741
1133;4;142;176;174;167;659
1134;4;151;164;170;155;640
1135;4;157;167;160;178;662
1136;4;126;160;160;112;558
1137;4;117;120;139;122;498
1138;4;117;123;122;130;492
1139;4;118;133;117;127;495
1140;4;105;114;123;107;449
1141;4;111;121;125;119;476
1142;4;93;106;114;111;424
1143;4;98;126;105;84;413
1144;4;81;91;110;96;378
1145;4;82;101;93;91;367
1146;4;83;87;87;82;339
1147;4;81;85;77;87;330
1148;4;80;72;90;87;329
1149;4;69;67;87;72;295
1150;4;71;73;69;75;288
1151;4;47;70;71;62;250
1152;4;64;67;77;75;283
1153;4;51;73;62;65;251
1154;4;62;58;77;78;275
1155;4;47;70;67;53;237
1156;4;43;54;65;59;221
1157;4;46;50;56;61;213
1158;4;43;51;40;50;184
1159;4;41;57;49;55;202
1160;4;45;56;59;41;201
1161;4;45;54;44;40;183
1162;4;32;40;37;43;152
1163;4;37;42;43;30;152
1164;4;41;51;42;28;162
1165;4;38;38;38;36;150
1166;4;24;48;35;23;130
1167;4;19;34;34;39;126
1168;4;23;33;26;27;109
1169;4;31;26;28;30;115
1170;4;22;27;34;35;118
1171;4;31;23;40;31;125
1172;4;22;33;29;27;111
1173;4;33;24;34;35;126
1174;4;13;28;33;22;96
1175;4;15;22;33;28;98
1176;4;22;22;19;31;94
1177;4;22;27;22;34;105
1178;4;18;26;17;23;84
1179;4;18;16;24;19;77
1180;4;19;20;21;24;84
1181;4;12;19;25;24;80
1182;4;12;35;22;21;90
1183;4;7;22;19;14;62
1184;4;9;8;22;14;53
1185;4;16;17;13;21;67
1186;4;19;20;9;14;62
1187;4;11;11;14;18;54
1188;4;19;13;19;19;70
1189;4;17;18;14;17;66
1190;4;8;9;14;16;47
1191;4;12;15;13;15;55
1192;4;9;11;11;11;42
1193;4;16;11;9;16;52
1194;4;14;18;14;8;54
1195;4;12;18;17;11;58
1196;4;1;11;14;9;35
1197;4;11;14;14;14;53
1198;4;7;8;6;9;30
1199;4;8;14;11;12;45
1200;4;7;14;11;10;42
1201;4;12;10;13;14;49
1202;4;13;12;14;5;44
1203;4;9;5;9;10;33
1204;4;7;8;5;9;29
1205;4;12;7;14;9;42
1206;4;7;13;10;3;33
1207;4;5;13;18;12;48
1208;4;6;11;8;5;30
1209;4;10;9;12;11;42
1210;4;10;11;15;6;42
1211;4;3;8;11;5;27
1212;4;7;7;11;3;28
1213;4;6;7;9;8;30
1214;4;5;7;8;11;31
1215;4;2;6;11;5;24
1216;4;5;11;13;13;42
1217;4;3;6;6;7;22
1218;4;5;6;5;6;22
1219;4;4;7;10;5;26
1220;4;6;6;10;6;28
1221;4;5;9;4;11;29
1222;4;5;4;10;7;26
1223;4;3;6;11;10;30
1224;4;7;8;5;6;26
1225;4;2;6;8;4;20
1226;4;4;9;8;6;27
1227;4;6;4;5;2;17
1228;4;6;5;3;6;20
1229;4;5;4;8;7;24
1230;4;5;5;7;5;22
1231;4;6;3;5;5;19
1232;4;4;2;11;11;28
1233;4;6;6;3;2;17
1234;4;2;6;9;7;24
1235;4;2;4;3;4;13
1236;4;5;4;12;4;25
1237;4;0;4;4;5;13
1238;4;3;2;4;4;13
1239;4;7;8;3;8;26
1240;4;3;0;6;6;15
1241;4;5;4;4;3;16
1242;4;3;8;4;4;19
1243;4;4;7;3;1;15
1244;4;3;5;4;4;16
1245;4;1;5;9;6;21
1246;4;2;13;7;7;29
1247;4;5;5;5;4;19
1248;4;4;2;4;4;14
1249;4;6;1;5;7;19
1250;4;6;7;3;1;17
1251;4;2;5;5;5;17
1252;4;7;3;6;6;22
1253;4;2;5;3;7;17
1254;4;3;8;7;10;28
1255;4;4;4;6;2;16
1256;4;4;5;5;5;19
1257;4;8;1;6;1;16
1258;4;2;3;6;3;14
1259;4;3;4;4;5;16
1260;4;1;7;5;5;18
1261;4;1;6;4;7;18
1262;4;3;5;4;5;17
1263;4;6;10;8;6;30
1264;4;1;5;7;5;18
1265;4;4;4;5;4;17
1266;4;7;3;4;7;21
1267;4;1;6;6;6;19
1268;4;2;4;4;3;13
1269;4;8;6;4;2;20
1270;4;7;3;4;7;21
1271;4;7;8;3;3;21
1272;4;5;7;0;4;16
1273;4;10;5;2;2;19
1274;4;3;2;3;3;11
1275;4;6;7;7;5;25
1276;4;3;3;1;2;9
1277;4;2;3;3;3;11
1278;4;2;8;3;6;19
1279;4;4;4;2;3;13
1280;4;3;2;4;5;14
1281;4;1;7;4;4;16
1282;4;3;3;6;3;15
1283;4;5;9;6;5;25
1284;4;4;4;10;6;24
1285;4;5;6;9;3;23
1286;4;3;5;7;4;19
1287;4;6;6;2;3;17
1288;4;5;3;2;4;14
1289;4;4;6;6;5;21
1290;4;6;6;6;6;24
1291;4;7;6;5;0;18
1292;4;5;4;1;5;15
1293;4;2;3;1;2;8
1294;4;7;7;4;4;22
1295;4;3;7;4;3;17
1296;4;6;1;5;3;15
1297;4;4;5;3;5;17
1298;4;5;8;4;7;24
1299;4;5;8;2;7;22
1300;4;5;3;2;5;15
1301;4;2;3;4;4;13
1302;4;4;4;8;8;24
1303;4;2;3;5;4;14
1304;4;1;7;4;4;16
1305;4;7;5;3;5;20
1306;4;4;11;6;5;26
1307;4;3;3;7;4;17
1308;4;4;3;2;4;13
1309;4;6;3;2;3;14
1310;4;2;5;5;2;14
1311;4;5;5;4;4;18
1312;4;7;1;2;3;13
1313;4;3;7;8;3;21
1314;4;7;5;5;6;23
1315;4;2;4;8;4;18
1316;4;5;4;5;3;17
1317;4;4;4;3;3;14
1318;4;6;3;0;3;12
1319;4;3;3;5;3;14
1320;4;2;3;3;4;12
1321;4;5;7;7;6;25
1322;4;6;3;2;3;14
1323;4;2;2;2;10;16
1324;4;3;3;5;6;17
1325;4;6;6;5;7;24
1326;4;7;10;2;2;21
1327;4;7;4;3;6;20
1328;4;2;5;6;5;18
1329;4;3;7;6;1;17
1330;4;7;3;10;3;23
1331;4;4;3;5;5;17
1332;4;0;9;2;6;17
1333;4;3;7;4;7;21
1334;4;2;6;1;5;14
1335;4;4;6;3;1;14
1336;4;3;5;6;5;19
1337;4;2;6;3;4;15
1338;4;2;2;5;3;12
1339;4;7;2;8;4;21
1340;4;7;5;4;2;18
1341;4;2;4;3;6;15
1342;4;3;6;2;5;16
1343;4;5;3;1;1;10
1344;4;6;2;2;3;13
1345;4;3;6;5;4;18
1346;4;1;5;1;7;14
1347;4;6;0;4;8;18
1348;4;2;2;4;4;12
1349;4;3;4;5;4;16
1350;4;4;1;9;1;15
1351;4;2;6;8;8;24
1352;4;2;3;4;4;13
1353;4;6;8;8;2;24
1354;4;4;6;0;5;15
1355;4;3;5;4;2;14
1356;4;4;4;3;8;19
1357;4;2;6;6;4;18
1358;4;5;5;6;6;22
1359;4;3;4;7;6;20
1360;4;3;4;4;1;12
1361;4;7;5;5;3;20
1362;4;4;4;3;3;14
1363;4;7;4;7;3;21
1364;4;3;2;8;2;15
1365;4;2;3;3;7;15
1366;4;2;4;4;6;16
1367;4;6;5;10;3;24
1368;4;4;0;6;6;16
1369;4;6;5;5;6;22
1370;4;5;7;5;5;22
1371;4;2;7;4;6;19
1372;4;1;0;4;4;9
1373;4;4;8;3;4;19
1374;4;6;3;3;2;14
1375;4;1;2;2;4;9
1376;4;11;7;9;12;39
1377;4;1;1;5;5;12
1378;4;3;3;7;3;16
1379;4;3;4;5;4;16
1380;4;5;7;5;2;19
1381;4;4;4;3;4;15
1382;4;1;6;6;3;16
1383;4;1;1;7;2;11
1384;4;5;4;6;5;20
1385;4;2;7;3;4;16
1386;4;2;4;2;8;16
1387;4;5;1;4;2;12
1388;4;7;2;4;8;21
1389;4;2;5;5;5;17
1390;4;3;7;9;4;23
1391;4;5;8;4;4;21
1392;4;2;3;4;3;12
1393;4;3;8;7;8;26
1394;4;6;5;5;5;21
1395;4;3;1;5;7;16
1396;4;6;0;2;6;14
1397;4;7;4;5;2;18
1398;6;7;5;4;5;21
1399;6;2;5;0;5;12
1400;6;2;1;8;4;15
1401;6;4;5;4;3;16
1402;6;6;8;9;3;26
1403;6;5;6;4;3;18
1404;6;3;6;4;4;17
1405;6;5;4;6;1;16
1406;6;2;2;3;3;10
1407;6;7;3;3;4;17
1408;6;4;5;6;5;20
1409;6;4;4;6;2;16
1410;6;7;3;2;3;15
1411;6;1;3;1;3;8
1412;6;4;2;3;7;16
1413;6;6;5;1;9;21
1414;6;5;7;4;7;23
1415;6;6;5;0;2;13
1416;6;2;4;2;5;13
1417;6;2;4;5;5;16
1418;6;3;3;4;2;12
1419;6;6;5;2;5;18
1420;6;4;4;7;3;18
1421;6;3;3;8;4;18
1422;6;4;3;5;8;20
1423;6;5;6;4;4;19
1424;6;3;6;2;3;14
1425;6;5;2;3;4;14
1426;6;6;8;2;2;18
1427;6;4;8;3;3;18
1428;6;8;5;3;3;19
1429;6;4;5;5;2;16
1430;6;3;5;4;3;15
1431;6;4;6;3;3;16
1432;6;1;10;6;6;23
1433;6;4;8;2;5;19
1434;6;4;2;2;3;11
1435;6;4;3;4;11;22
1436;6;2;6;5;1;14
1437;6;5;5;4;5;19
1438;6;0;8;3;3;14
1439;6;2;9;5;4;20
1440;6;4;5;6;1;16
1441;6;6;6;1;6;19
1442;6;2;6;1;6;15
1443;6;2;5;6;5;18
1444;6;4;7;7;7;25
1445;6;6;3;3;3;15
1446;6;5;1;2;3;11
1447;6;7;6;2;6;21
1448;6;3;6;7;3;19
1449;6;7;2;2;9;20
1450;6;2;8;4;5;19
1451;6;3;4;2;2;11
1452;6;3;3;1;6;13
1453;6;1;3;6;7;17
1454;6;5;1;3;5;14
1455;6;5;2;8;6;21
1456;6;1;6;4;4;15
1457;6;3;4;3;3;13
1458;6;4;9;2;6;21
1459;6;3;9;2;9;23
1460;6;5;4;9;4;22
1461;6;6;4;4;6;20
1462;6;3;3;5;3;14
1463;6;5;3;5;1;14
1464;6;4;4;4;3;15
1465;6;2;5;8;5;20
1466;6;6;6;2;4;18
1467;6;4;4;4;3;15
1468;6;3;6;7;3;19
1469;6;4;5;2;5;16
1470;6;5;3;5;3;16
1471;6;4;2;3;0;9
1472;6;6;6;1;3;16
1473;6;1;5;5;4;15
1474;6;1;3;8;2;14
1475;6;3;2;8;5;18
1476;6;3;0;4;3;10
1477;6;2;5;5;1;13
1478;6;4;3;5;2;14
1479;6;1;3;4;5;13
1480;6;5;5;4;5;19
1481;6;2;4;5;3;14
1482;6;0;2;6;4;12
1483;6;5;3;5;3;16
1484;6;3;4;4;5;16
1485;6;2;5;4;6;17
1486;6;5;2;5;2;14
1487;6;4;5;6;5;20
1488;6;4;3;3;2;12
1489;6;1;6;6;3;16
1490;6;5;5;3;4;17
1491;6;3;4;8;5;20
1492;6;4;7;6;1;18
1493;6;3;4;3;1;11
1494;6;3;4;3;3;13
1495;6;4;2;3;7;16
1496;6;3;1;5;9;18
1497;6;5;5;3;2;15
1498;6;4;2;7;3;16
1499;6;2;3;2;3;10
1500;6;1;1;7;4;13
1501;6;6;6;1;5;18
1502;6;4;3;2;4;13
1503;6;1;8;3;5;17
1504;6;1;6;5;3;15
1505;6;3;1;8;3;15
1506;6;2;2;3;5;12
1507;6;7;2;4;5;18
1508;6;4;3;6;4;17
1509;6;3;1;3;1;8
1510;6;7;3;4;11;25
1511;6;3;1;6;4;14
1512;6;5;0;5;2;12
1513;6;4;6;8;7;25
1514;6;4;2;0;4;10
1515;6;11;2;2;3;18
1516;6;5;3;2;7;17
1517;6;4;3;7;2;16
1518;6;5;4;5;4;18
1519;6;0;6;4;4;14
1520;6;5;1;5;6;17
1521;6;4;6;3;3;16
1522;6;3;3;3;5;14
1523;6;3;2;4;3;12
1524;6;4;3;2;9;18
1525;6;3;5;4;2;14
1526;6;3;2;3;6;14
1527;6;2;3;3;6;14
1528;6;4;2;12;2;20
1529;6;3;5;4;5;17
1530;6;2;3;2;8;15
1531;6;2;3;4;2;11
1532;6;5;3;3;2;13
1533;6;2;5;1;3;11
1534;6;7;1;4;3;15
1535;6;5;0;6;3;14
1536;6;0;5;2;7;14
1537;6;3;3;2;4;12
1538;6;3;4;6;2;15
1539;6;5;7;2;7;21
1540;6;3;1;2;5;11
1541;8;943;902;912;899;3656
1542;8;900;865;832;823;3420
1543;8;804;890;817;804;3315
1544;8;759;811;791;731;3092
1545;8;759;818;699;766;3042
1546;8;725;765;722;749;2961
1547;8;750;720;697;682;2849
1548;8;661;672;712;690;2735
1549;8;657;739;680;625;2701
1550;8;626;623;634;621;2504
1551;8;556;611;580;605;2352
1552;8;523;617;563;553;2256
1553;8;554;569;580;542;2245
1554;8;529;551;535;529;2144
1555;8;494;551;527;524;2096
1556;8;481;548;493;476;1998
1557;8;406;493;496;458;1853
1558;8;433;492;463;434;1822
1559;8;434;465;487;441;1827
1560;8;396;418;453;425;1692
1561;8;379;419;382;414;1594
1562;8;379;417;419;401;1616
1563;8;377;388;384;375;1524
1564;8;322;402;378;337;1439
1565;8;345;388;379;341;1453
1566;8;295;328;346;335;1304
1567;8;279;311;331;310;1231
1568;8;272;299;282;303;1156
1569;8;275;323;299;276;1173
1570;8;242;311;292;254;1099
1571;8;230;289;276;262;1057
1572;8;259;275;267;254;1055
1573;8;241;281;259;237;1018
1574;8;233;229;255;253;970
1575;8;223;252;237;212;924
1576;8;190;221;222;226;859
1577;8;205;232;212;201;850
1578;8;192;203;210;194;799
1579;8;153;180;185;184;702
1580;8;150;203;185;172;710
1581;8;133;182;160;173;648
1582;8;142;177;158;148;625
1583;8;132;141;165;155;593
1584;8;139;156;138;140;573
1585;8;130;158;140;147;575
1586;8;110;141;150;118;519
1587;8;133;125;128;144;530
1588;8;111;130;122;123;486
1589;8;101;134;134;121;490
1590;8;112;126;122;108;468
1591;8;106;96;135;125;462
1592;8;84;138;106;109;437
1593;8;93;89;109;89;380
1594;8;80;123;109;100;412
1595;8;93;108;92;82;375
1596;8;66;120;91;83;360
1597;8;69;81;95;80;325
1598;8;79;92;79;65;315
1599;8;73;71;78;79;301
1600;8;79;97;75;75;326
1601;8;59;62;78;67;266
1602;8;70;80;71;61;282
1603;8;56;90;70;75;291
1604;8;60;67;76;63;266
1605;8;60;76;58;88;282
1606;8;60;62;68;67;257
1607;8;60;52;49;71;232
1608;8;43;45;55;55;198
1609;8;52;48;50;42;192
1610;8;61;60;57;53;231
1611;8;32;54;42;49;177
1612;8;33;50;53;39;175
1613;8;40;45;50;40;175
1614;8;40;53;50;46;189
1615;8;32;41;31;50;154
1616;8;35;51;38;39;163
1617;8;26;42;46;43;157
1618;8;33;41;46;41;161
1619;8;27;33;31;37;128
1620;8;39;38;26;26;129
1621;8;37;31;36;39;143
1622;8;26;30;32;35;123
1623;8;22;30;28;27;107
1624;8;19;31;32;33;115
1625;8;25;24;36;23;108
1626;8;34;32;24;24;114
1627;8;13;35;19;23;90
1628;8;24;30;26;26;106
1629;8;25;23;31;28;107
1630;8;24;18;29;22;93
1631;8;26;27;20;23;96
1632;8;19;19;23;26;87
1633;8;15;15;25;22;77
1634;8;17;15;26;15;73
1635;8;23;15;24;15;77
1636;8;13;17;12;10;52
1637;8;17;21;18;12;68
1638;8;16;16;14;16;62
1639;8;12;17;17;14;60
1640;8;20;20;21;5;66
1641;8;13;26;18;13;70
1642;8;12;19;17;16;64
1643;8;11;17;18;18;64
1644;8;16;16;21;13;66
1645;8;25;13;15;18;71
1646;8;6;17;10;9;42
1647;8;21;13;13;16;63
1648;8;8;12;14;18;52
1649;8;9;18;24;14;65
1650;8;10;17;14;14;55
1651;8;15;11;11;15;52
1652;8;17;18;11;17;63
1653;8;19;14;13;17;63
1654;8;13;10;19;10;52
1655;8;9;14;14;10;47
1656;8;6;12;14;10;42
1657;8;11;9;13;17;50
1658;8;17;8;14;11;50
1659;8;7;13;13;11;44
1660;8;21;14;8;15;58
1661;8;10;3;13;12;38
1662;8;13;12;12;9;46
1663;8;10;8;15;9;42
1664;8;10;10;6;9;35
1665;8;15;8;9;9;41
1666;8;10;12;17;6;45
1667;8;16;17;13;11;57
1668;8;6;19;17;11;53
1669;8;6;10;12;11;39
1670;8;10;12;10;3;35
1671;8;12;18;11;12;53
1672;8;9;8;12;12;41
1673;8;9;14;10;12;45
1674;8;4;7;10;7;28
1675;8;8;14;14;4;40
1676;8;5;9;7;9;30
1677;8;5;10;14;19;48
1678;8;8;8;5;15;36
1679;8;8;8;6;13;35
1680;8;7;13;6;11;37
1681;8;7;9;13;11;40
1682;8;9;13;5;7;34
1683;8;6;13;12;5;36
1684;8;10;12;10;3;35
1685;8;6;8;9;10;33
1686;8;11;8;15;9;43
1687;8;14;11;8;6;39
1688;8;6;4;5;7;22
1689;8;13;3;11;8;35
1690;8;8;11;12;2;33
1691;8;12;9;10;5;36
1692;8;6;13;16;12;47
1693;8;7;9;12;8;36
1694;8;6;9;9;7;31
1695;8;8;6;11;12;37
1696;8;8;10;8;10;36
1697;8;10;14;9;14;47
1698;8;10;12;8;5;35
1699;8;4;14;6;3;27
1700;8;4;8;8;12;32
1701;8;10;9;10;9;38
1702;8;4;10;5;10;29
1703;8;7;7;10;10;34
1704;8;6;6;9;7;28
1705;8;6;10;10;13;39
1706;8;16;5;10;8;39
1707;8;21;9;5;10;45
1708;8;13;8;6;11;38
1709;8;5;10;9;5;29
1710;8;3;11;11;11;36
1711;8;7;8;6;6;27
1712;8;8;4;12;5;29
1713;8;9;6;13;7;35
1714;8;6;5;11;10;32
1715;8;13;7;8;10;38
1716;8;6;11;10;2;29
1717;8;9;10;11;5;35
1718;8;8;10;15;10;43
1719;8;6;4;14;8;32
1720;8;9;11;8;8;36
1721;8;7;10;5;9;31
1722;8;9;10;6;11;36
1723;8;4;6;11;10;31
1724;8;8;9;10;9;36
1725;8;4;14;7;7;32
1726;8;6;9;12;6;33
1727;8;6;3;9;9;27
1728;8;6;7;11;7;31
1729;8;4;4;7;6;21
1730;8;4;8;9;6;27
1731;8;8;8;12;4;32
1732;8;5;8;8;4;25
1733;8;4;6;14;6;30
1734;8;5;7;6;5;23
1735;8;7;7;9;6;29
1736;8;6;5;4;5;20
1737;8;5;6;10;0;21
1738;8;6;12;9;9;36
1739;8;5;5;9;11;30
1740;8;10;8;9;1;28
1741;8;2;9;7;5;23
1742;8;6;5;9;7;27
1743;8;8;10;3;9;30
1744;8;11;4;8;9;32
1745;8;5;6;11;5;27
1746;8;8;10;3;10;31
1747;8;5;10;8;7;30
1748;8;4;2;6;6;18
1749;8;8;7;4;4;23
1750;8;4;10;11;7;32
1751;8;3;7;7;9;26
1752;8;6;7;7;13;33
1753;8;6;5;12;6;29
1754;8;5;10;8;7;30
1755;8;7;10;18;6;41
1756;8;4;10;10;10;34
1757;8;5;5;10;9;29
1758;8;6;8;11;10;35
1759;8;7;7;6;5;25
1760;8;4;8;8;10;30
1761;8;9;6;7;7;29
1762;8;6;4;5;10;25
1763;8;2;14;3;7;26
1764;8;6;3;10;6;25
1765;8;8;9;11;5;33
1766;8;3;6;10;2;21
1767;8;7;7;6;9;29
1768;8;5;10;6;5;26
1769;8;4;11;12;11;38
1770;8;5;12;8;8;33
1771;8;5;6;6;8;25
1772;8;6;9;13;9;37
1773;8;4;13;10;11;38
1774;8;4;7;9;1;21
1775;8;4;12;5;9;30
1776;8;7;9;7;8;31
1777;8;9;11;3;6;29
1778;8;3;9;8;4;24
1779;8;7;7;6;7;27
1780;8;3;7;9;5;24
1781;8;4;4;4;10;22
1782;8;7;5;11;4;27
1783;8;8;1;5;10;24
1784;8;6;11;11;13;41
1785;8;8;8;5;6;27
1786;8;4;8;3;5;20
1787;8;6;3;10;9;28
1788;8;13;8;5;11;37
1789;8;5;11;4;9;29
1790;8;8;8;7;6;29
1791;8;10;5;11;6;32
1792;8;6;8;8;5;27
1793;8;5;7;7;11;30
1794;8;1;7;6;5;19
1795;8;10;11;9;14;44
1796;8;10;9;6;7;32
1797;8;9;10;7;5;31
1798;8;7;3;4;9;23
1799;8;9;6;9;6;30
1800;8;4;5;8;8;25
1801;8;3;2;5;7;17
1802;8;7;8;9;5;29
1803;8;5;6;7;5;23
1804;8;7;6;6;4;23
1805;8;7;9;8;9;33
1806;8;7;6;5;9;27
1807;8;6;11;7;13;37
1808;8;7;12;13;9;41
1809;8;9;4;2;4;19
1810;8;5;10;14;5;34
1811;8;8;10;4;7;29
1812;8;7;8;10;6;31
1813;8;7;10;14;5;36
1814;8;3;3;3;7;16
1815;8;8;7;4;9;28
1816;8;6;9;8;8;31
1817;8;16;9;6;10;41
1818;8;4;7;11;10;32
1819;8;9;5;5;10;29
1820;8;9;10;3;8;30
1821;8;5;6;7;7;25
1822;8;8;9;9;4;30
1823;8;5;11;9;13;38
1824;8;5;5;5;10;25
1825;8;2;6;7;8;23
1826;8;5;4;5;3;17
1827;8;9;5;5;9;28
1828;8;9;6;4;7;26
1829;8;8;4;7;8;27
1830;8;10;4;10;9;33
1831;8;6;8;7;11;32
1832;8;7;10;6;8;31
1833;8;8;9;5;10;32
1834;8;4;8;7;9;28
1835;8;6;13;8;2;29
1836;8;7;10;5;4;26
1837;8;3;10;7;7;27
1838;8;7;9;6;7;29
1839;8;4;16;10;9;39
1840;8;6;8;5;11;30
1841;8;12;8;11;9;40
1842;8;5;8;7;5;25
1843;8;6;13;10;8;37
1844;8;4;5;6;13;28
1845;8;1;11;6;12;30
1846;8;7;5;7;6;25
1847;8;7;4;7;6;24
1848;8;4;7;6;7;24
1849;8;5;3;5;6;19
1850;8;9;9;2;4;24
1851;8;10;10;4;10;34
1852;8;7;10;11;6;34
1853;8;4;8;8;4;24
1854;8;2;5;5;10;22
1855;8;13;10;8;9;40
1856;8;7;5;12;11;35
1857;8;5;8;7;8;28
1858;8;4;5;5;1;15
1859;8;6;7;7;7;27
1860;8;10;5;10;10;35
1861;8;7;8;6;5;26
1862;8;6;6;14;9;35
1863;8;5;5;4;9;23
1864;8;11;4;5;13;33
1865;8;9;6;9;7;31
1866;8;6;11;5;5;27
1867;8;3;7;13;10;33
1868;8;4;9;8;4;25
1869;8;3;10;10;5;28
1870;8;10;9;4;8;31
1871;8;7;9;7;7;30
1872;8;3;4;7;12;26
1873;8;5;7;9;8;29
1874;8;11;8;10;8;37
1875;8;4;10;13;6;33
1876;8;4;3;5;6;18
1877;8;6;6;10;5;27
1878;8;5;6;5;8;24
1879;8;9;3;3;10;25
1880;8;9;4;6;5;24
1881;8;6;11;12;5;34
1882;8;7;8;4;14;33
1883;8;7;8;6;8;29
1884;8;7;6;3;10;26
1885;8;11;3;8;9;31
1886;8;2;10;9;4;25
1887;8;11;10;7;4;32
1888;8;3;8;6;8;25
1889;8;9;10;8;10;37
1890;8;8;6;7;5;26
1891;8;3;3;8;6;20
1892;8;11;4;13;7;35
1893;8;7;5;8;6;26
1894;8;9;10;3;7;29
1895;8;9;5;7;9;30
1896;8;4;3;5;6;18
1897;8;9;12;10;4;35
1898;8;5;6;6;5;22
1899;8;3;12;8;4;27
1900;8;7;3;6;10;26
1901;8;9;7;8;9;33
1902;8;4;8;8;7;27
1903;8;3;2;8;7;20
1904;8;7;10;4;8;29
1905;8;5;1;8;1;15
1906;8;6;4;4;7;21
1907;8;5;7;6;7;25
1908;8;5;10;12;6;33
1909;8;5;11;6;8;30
1910;8;4;6;3;5;18
1911;8;7;9;5;11;32
1912;8;3;5;5;6;19
1913;8;3;2;7;2;14
1914;8;6;5;10;5;26
1915;8;4;9;9;8;30
1916;8;6;8;6;5;25
1917;8;8;7;12;5;32
1918;8;11;5;10;7;33
1919;8;5;9;12;5;31
1920;8;1;8;8;8;25
1921;8;4;8;5;5;22
1922;8;8;8;8;4;28
1923;8;4;5;7;6;22
1924;8;5;5;8;4;22
1925;8;6;7;5;9;27
1926;8;6;6;6;6;24
1927;8;3;9;4;7;23
1928;8;8;8;9;3;28
1929;8;5;1;11;6;23
1930;8;2;4;8;7;21
1931;8;10;10;8;10;38
1932;8;0;5;11;6;22
1933;8;5;11;11;8;35
1934;8;7;6;7;3;23
1935;8;11;3;5;3;22
1936;8;8;9;11;11;39
1937;8;3;7;4;6;20
1938;8;5;11;4;6;26
1939;8;7;10;5;6;28
1940;8;3;6;7;6;22
1941;8;9;7;10;5;31
1942;8;8;6;7;7;28
1943;8;5;10;5;7;27
1944;8;5;14;9;9;37
1945;8;3;2;7;9;21
1946;8;5;4;7;3;19
1947;8;4;6;13;7;30
1948;8;7;8;7;4;26
1949;8;2;4;7;8;21
1950;8;6;4;11;6;27
1951;8;3;8;11;3;25
1952;8;7;5;6;9;27
1953;8;3;4;3;3;13
1954;8;7;6;3;6;22
1955;8;8;10;6;5;29
1956;8;5;4;14;6;29
1957;8;6;5;7;4;22
1958;8;4;10;7;8;29
1959;8;6;4;7;5;22
1960;8;3;2;8;9;22
1961;8;4;11;9;4;28
1962;8;7;8;7;8;30
1963;8;7;15;6;12;40
1964;8;7;8;4;9;28
1965;8;4;6;6;8;24
1966;8;4;5;10;11;30
1967;8;3;8;5;4;20
1968;8;6;3;2;4;15
1969;8;5;8;4;3;20
1970;8;8;2;4;7;21
1971;8;7;6;8;7;28
1972;8;6;6;3;5;20
1973;8;7;4;6;6;23
1974;8;6;8;10;5;29
1975;8;8;7;6;7;28
1976;8;8;10;4;6;28
1977;8;4;8;5;8;25
1978;8;4;2;4;7;17
1979;8;6;5;11;5;27
1980;8;10;2;5;7;24
1981;8;9;7;6;9;31
1982;8;8;5;5;5;23
1983;8;7;7;6;7;27
1984;8;3;7;9;6;25
1985;8;5;12;3;7;27
1986;10;497;495;526;521;2039
1987;10;440;497;469;433;1839
1988;10;432;469;431;399;1731
1989;10;391;444;426;414;1675
1990;10;386;412;411;378;1587
1991;10;381;402;395;392;1570
1992;10;355;376;380;389;1500
1993;10;333;350;376;378;1437
1994;10;325;330;346;311;1312
1995;10;294;337;327;302;1260
1996;10;274;319;329;310;1232
1997;10;291;306;292;295;1184
1998;10;277;288;286;278;1129
1999;10;249;288;303;288;1128
2000;10;289;283;287;265;1124
2001;10;250;277;243;243;1013
2002;10;231;237;252;244;964
2003;10;195;215;228;242;880
2004;10;185;236;253;220;894
2005;10;197;216;237;237;887
2006;10;185;220;218;186;809
2007;10;176;187;206;187;756
2008;10;180;191;181;178;730
2009;10;159;169;189;170;687
2010;10;147;177;182;169;675
2011;10;153;164;152;142;611
2012;10;141;151;152;146;590
2013;10;151;154;155;138;598
2014;10;133;155;142;149;579
2015;10;130;150;145;142;567
2016;10;106;156;150;116;528
2017;10;108;141;116;135;500
2018;10;94;109;89;116;408
2019;10;103;114;112;112;441
2020;10;104;114;101;101;420
2021;10;87;86;120;93;386
2022;10;95;111;100;88;394
2023;10;105;114;123;101;443
2024;10;83;99;84;103;369
2025;10;82;101;106;77;366
2026;10;60;90;108;79;337
2027;10;73;92;81;74;320
2028;10;67;66;67;78;278
2029;10;65;81;86;85;317
2030;10;73;77;81;72;303
2031;10;70;71;65;77;283
2032;10;55;76;74;71;276
2033;10;48;48;52;65;213
2034;10;59;56;54;54;223
2035;10;56;62;58;47;223
2036;10;52;61;55;53;221
2037;10;45;52;59;60;216
2038;10;55;55;51;59;220
2039;10;43;54;43;43;183
2040;10;46;57;45;42;190
2041;10;43;46;50;44;183
2042;10;40;44;49;49;182
2043;10;39;48;47;48;182
2044;10;28;42;29;46;145
2045;10;24;37;41;35;137
2046;10;31;31;35;36;133
2047;10;41;42;39;34;156
2048;10;26;41;37;34;138
2049;10;25;25;31;20;101
2050;10;27;33;29;35;124
2051;10;32;29;21;30;112
2052;10;30;36;32;21;119
2053;10;22;26;31;28;107
2054;10;23;36;37;18;114
2055;10;36;21;21;42;120
2056;10;24;22;21;25;92
2057;10;25;29;23;28;105
2058;10;16;23;24;24;87
2059;10;21;25;22;23;91
2060;10;14;16;24;29;83
2061;10;14;20;26;22;82
2062;10;20;25;22;22;89
2063;10;13;24;25;17;79
2064;10;16;28;20;12;76
2065;10;18;17;20;18;73
2066;10;12;23;15;22;72
2067;10;16;26;18;15;75
2068;10;12;21;19;13;65
2069;10;18;15;14;23;70
2070;10;20;23;19;19;81
2071;10;15;20;17;16;68
2072;10;12;19;27;17;75
2073;10;17;19;17;11;64
2074;10;13;10;19;14;56
2075;10;15;16;23;17;71
2076;10;14;15;20;7;56
2077;10;15;15;14;8;52
2078;10;16;17;17;12;62
2079;10;15;19;16;14;64
2080;10;13;19;21;9;62
2081;10;19;16;12;11;58
2082;10;6;17;14;16;53
2083;10;11;6;15;17;49
2084;10;19;22;12;8;61
2085;10;12;14;14;9;49
2086;10;15;13;14;12;54
2087;10;10;13;9;17;49
2088;10;14;14;11;12;51
2089;10;15;6;12;21;54
2090;10;13;17;13;7;50
2091;10;7;17;13;11;48
2092;10;8;10;14;15;47
2093;10;8;14;11;14;47
2094;10;10;9;10;5;34
2095;10;14;12;12;10;48
2096;10;6;10;8;14;38
2097;10;131;37;9;75;252
2098;10;39;20;13;33;105
2099;10;10;14;12;8;44
2100;10;11;10;11;8;40
2101;10;11;13;8;9;41
2102;10;7;7;10;9;33
2103;10;16;10;9;12;47
2104;10;8;12;11;8;39
2105;10;16;13;15;12;56
2106;10;12;10;11;18;51
2107;10;9;12;6;8;35
2108;10;9;8;13;11;41
2109;10;10;7;10;10;37
2110;10;9;11;11;9;40
2111;10;6;7;6;9;28
2112;10;8;9;7;11;35
2113;10;9;14;10;2;35
2114;10;11;15;10;9;45
2115;10;9;14;15;9;47
2116;10;12;11;11;6;40
2117;10;11;11;7;11;40
2118;10;6;13;7;7;33
2119;10;4;6;10;11;31
2120;10;10;11;8;10;39
2121;10;8;11;15;6;40
2122;10;8;9;10;6;33
2123;10;6;8;4;9;27
2124;10;5;14;12;11;42
2125;10;14;10;6;9;39
2126;10;4;7;13;8;32
2127;10;4;5;13;7;29
2128;10;11;9;9;7;36
2129;10;12;6;4;7;29
2130;10;8;4;6;11;29
2131;10;7;6;7;9;29
2132;10;3;10;9;13;35
2133;10;8;11;16;8;43
2134;10;5;12;9;5;31
2135;10;5;8;9;5;27
2136;10;8;10;11;9;38
2137;10;7;5;13;10;35
2138;10;8;9;6;9;32
2139;10;6;4;6;7;23
2140;10;5;6;9;6;26
2141;10;5;8;10;8;31
2142;10;5;10;9;10;34
2143;10;7;7;11;11;36
2144;10;7;9;9;8;33
2145;10;9;6;7;11;33
2146;10;14;9;10;4;37
2147;10;9;11;11;7;38
2148;10;8;8;9;8;33
2149;10;6;10;9;8;33
2150;10;1;10;16;8;35
2151;10;7;11;8;7;33
2152;10;6;8;12;7;33
2153;10;7;9;5;8;29
2154;10;4;7;5;2;18
2155;10;5;10;9;8;32
2156;10;9;6;11;10;36
2157;10;6;11;11;11;39
2158;10;6;5;11;11;33
2159;10;8;7;12;6;33
2160;10;11;7;9;11;38
2161;10;9;10;13;11;43
2162;10;12;7;9;7;35
2163;10;6;7;5;7;25
2164;10;5;8;4;10;27
2165;10;7;7;6;8;28
2166;10;4;10;8;6;28
2167;10;5;13;7;12;37
2168;10;8;10;7;13;38
2169;10;3;9;7;9;28
2170;10;14;9;8;9;40
2171;10;5;8;9;11;33
2172;10;9;6;6;7;28
2173;10;3;12;8;5;28
2174;10;9;7;4;14;34
2175;10;9;11;8;10;38
2176;10;5;9;6;7;27
2177;10;8;9;9;10;36
2178;10;10;11;9;8;38
2179;10;3;4;9;9;25
2180;10;5;13;4;12;34
2181;10;8;14;11;10;43
2182;10;8;7;7;5;27
2183;10;4;6;7;6;23
2184;10;9;10;11;11;41
2185;10;11;9;5;2;27
2186;10;5;9;11;7;32
2187;10;5;5;9;8;27
2188;10;6;7;7;10;30
2189;10;12;8;7;6;33
2190;10;6;8;5;6;25
2191;10;7;8;12;5;32
2192;10;5;5;8;11;29
2193;10;4;10;11;9;34
2194;10;9;11;13;5;38
2195;10;6;8;12;4;30
2196;10;6;9;11;9;35
2197;10;8;8;4;11;31
2198;10;7;8;10;7;32
2199;10;4;9;11;13;37
2200;10;7;8;8;13;36
2201;10;12;9;11;8;40
2202;10;4;12;12;8;36
2203;10;2;8;5;9;24
2204;10;9;10;11;14;44
2205;10;7;8;11;6;32
2206;10;8;7;6;10;31
2207;10;1;6;9;8;24
2208;10;7;8;16;5;36
2209;10;5;8;5;8;26
2210;10;5;11;4;5;25
2211;10;4;10;5;9;28
2212;10;7;2;8;6;23
2213;10;13;13;14;9;49
2214;10;6;10;7;6;29
2215;10;4;5;9;9;27
2216;10;3;3;13;3;22
2217;10;4;5;6;6;21
2218;10;6;11;9;9;35
2219;10;7;8;9;5;29
2220;10;9;7;5;7;28
2221;10;10;9;11;11;41
2222;10;9;13;7;17;46
2223;10;7;8;5;12;32
2224;10;9;7;6;10;32
2225;10;8;8;5;8;29
2226;10;5;12;6;11;34
2227;10;6;6;18;10;40
2228;10;4;11;5;6;26
2229;10;8;6;12;10;36
2230;10;5;10;9;5;29
2231;10;4;9;4;6;23
2232;10;4;9;6;7;26
2233;10;6;6;5;9;26
2234;10;7;11;5;5;28
2235;10;4;7;15;6;32
2236;10;7;4;11;11;33
2237;10;2;14;11;7;34
2238;10;7;8;14;6;35
2239;10;12;8;7;6;33
2240;10;5;8;8;6;27
2241;10;10;8;3;8;29
2242;10;9;4;10;7;30
2243;10;7;4;9;8;28
2244;10;9;8;9;14;40
2245;10;8;2;6;13;29
2246;10;10;13;8;4;35
2247;10;4;8;13;3;28
2248;10;9;9;14;10;42
2249;10;7;11;9;9;36
2250;10;6;5;7;9;27
2251;10;9;8;8;7;32
2252;10;6;4;10;9;29
2253;10;8;6;11;8;33
2254;10;2;9;6;7;24
2255;10;7;3;10;6;26
2256;10;2;12;9;6;29
2257;10;5;8;11;7;31
2258;10;6;4;6;6;22
2259;10;5;7;6;9;27
2260;10;10;7;11;5;33
2261;10;4;9;6;9;28
2262;10;9;4;5;7;25
2263;10;6;8;10;8;32
2264;10;6;6;10;7;29
2265;10;4;5;11;5;25
2266;10;10;9;7;5;31
2267;10;6;5;5;4;20
2268;10;8;6;8;3;25
2269;10;6;4;12;8;30
2270;10;4;7;13;6;30
2271;10;9;7;8;9;33
2272;10;10;10;5;6;31
2273;10;11;7;15;4;37
2274;10;6;8;5;8;27
2275;10;5;9;8;7;29
2276;10;4;7;8;14;33
2277;10;7;10;9;5;31
2278;10;8;5;8;4;25
2279;10;7;13;7;15;42
2280;10;5;10;15;5;35
2281;10;4;10;7;5;26
2282;10;7;10;9;7;33
2283;10;6;5;9;9;29
2284;10;3;15;10;8;36
2285;10;5;2;5;6;18
2286;10;11;7;6;7;31
2287;10;6;9;7;6;28
2288;10;5;9;8;8;30
2289;10;6;7;8;8;29
2290;10;6;9;5;8;28
2291;10;7;7;6;4;24
2292;10;5;6;6;8;25
2293;10;4;8;10;9;31
2294;10;6;13;4;3;26
2295;10;8;11;8;3;30
2296;10;10;9;11;12;42
2297;10;7;9;8;7;31
2298;10;4;11;5;7;27
2299;10;4;9;8;9;30
2300;10;10;5;6;7;28
2301;10;10;11;6;9;36
2302;10;7;12;6;6;31
2303;10;2;9;6;5;22
2304;10;8;6;11;14;39
2305;10;5;9;6;8;28
2306;10;5;4;11;7;27
2307;10;11;8;13;6;38
2308;10;11;9;9;5;34
2309;10;7;4;7;3;21
2310;10;5;4;5;7;21
2311;10;8;7;11;9;35
2312;10;9;7;12;8;36
2313;10;10;8;5;9;32
2314;10;3;7;7;9;26
2315;10;3;9;6;10;28
2316;10;9;8;9;7;33
2317;10;6;6;5;7;24
2318;10;7;4;5;5;21
2319;10;9;9;14;9;41
2320;10;2;9;11;7;29
2321;10;2;10;9;7;28
2322;10;7;9;7;3;26
2323;10;1;10;11;8;30
2324;10;8;5;10;7;30
2325;10;13;4;7;10;34
2326;10;4;6;8;6;24
2327;10;5;10;8;8;31
2328;10;7;5;4;5;21
2329;10;7;9;1;4;21
2330;10;6;10;6;11;33
2331;10;3;10;8;3;24
2332;10;9;7;6;9;31
2333;10;3;7;8;8;26
2334;10;9;8;4;6;27
2335;10;9;9;7;4;29
2336;10;3;9;7;10;29
2337;10;9;8;3;8;28
2338;10;9;5;2;7;23
2339;10;12;4;7;10;33
2340;10;3;6;8;15;32
2341;10;7;9;7;3;26
2342;10;8;9;9;7;33
2343;10;12;5;11;4;32
2344;10;9;9;7;7;32
2345;10;6;7;8;12;33
2346;10;15;3;11;6;35
2347;10;9;6;8;4;27
2348;10;6;6;8;3;23
2349;10;11;10;6;5;32
2350;10;5;2;8;9;24
2351;10;6;12;7;7;32
2352;10;3;7;8;11;29
2353;10;5;5;9;9;28
2354;10;4;8;6;7;25
2355;10;7;10;5;12;34
2356;10;8;5;7;8;28
2357;10;5;13;6;5;29
2358;10;6;9;12;3;30
2359;10;5;9;5;9;28
2360;10;6;7;13;11;37
2361;10;11;9;9;12;41
2362;10;7;8;4;8;27
2363;10;4;8;4;7;23
2364;10;7;7;7;5;26
2365;10;9;9;6;7;31
2366;10;5;10;5;4;24
2367;10;6;9;8;6;29
2368;10;6;8;6;4;24
2369;10;3;10;6;8;27
2370;10;3;3;9;5;20
2371;10;4;6;7;10;27
2372;10;7;9;9;15;40
2373;10;9;7;10;9;35
2374;10;9;7;7;7;30
2375;10;5;10;13;4;32
2376;10;10;6;4;7;27
2377;10;8;7;7;8;30
2378;10;6;8;10;7;31
2379;10;6;11;5;7;29
2380;10;5;6;11;13;35
2381;10;8;6;10;9;33
2382;10;9;9;8;5;31
2383;10;4;3;7;5;19
2384;10;4;9;8;9;30
2385;10;10;15;6;10;41
2386;10;8;9;6;8;31
2387;10;5;4;9;4;22
2388;10;4;8;9;10;31
2389;10;2;4;7;10;23
2390;10;2;10;7;9;28
2391;10;6;7;7;1;21
2392;12;261;278;287;264;1090
2393;12;189;240;228;214;871
2394;12;193;223;240;217;873
2395;12;207;214;204;191;816
2396;12;177;200;191;205;773
2397;12;173;182;176;172;703
2398;12;146;188;200;181;715
2399;12;162;180;195;186;723
2400;12;131;170;186;175;662
2401;12;127;179;156;150;612
2402;12;146;157;146;152;601
2403;12;117;156;137;137;547
2404;12;137;140;139;133;549
2405;12;131;131;131;117;510
2406;12;108;134;130;134;506
2407;12;117;119;128;127;491
2408;12;104;124;116;117;461
2409;12;99;115;103;104;421
2410;12;84;109;100;96;389
2411;12;89;90;107;91;377
2412;12;76;109;100;95;380
2413;12;83;82;89;105;359
2414;12;82;95;104;86;367
2415;12;75;108;81;77;341
2416;12;70;85;68;79;302
2417;12;75;63;81;80;299
2418;12;53;70;84;77;284
2419;12;59;77;65;66;267
2420;12;73;65;75;67;280
2421;12;52;71;57;57;237
2422;12;47;57;70;58;232
2423;12;62;57;60;67;246
2424;12;64;55;56;55;230
2425;12;49;68;66;50;233
2426;12;41;41;43;40;165
2427;12;44;58;54;58;214
2428;12;45;51;60;52;208
2429;12;40;44;46;54;184
2430;12;41;57;56;46;200
2431;12;28;38;50;41;157
2432;12;45;47;36;41;169
2433;12;41;51;39;44;175
2434;12;39;28;35;33;135
2435;12;27;49;36;44;156
2436;12;36;34;35;33;138
2437;12;40;38;26;29;133
2438;12;24;29;32;29;114
2439;12;25;22;37;38;122
2440;12;24;27;46;32;129
2441;12;28;25;30;24;107
2442;12;20;23;33;27;103
2443;12;19;37;30;31;117
2444;12;24;31;30;31;116
2445;12;22;25;25;20;92
2446;12;28;29;23;23;103
2447;12;23;32;15;27;97
2448;12;20;30;19;13;82
2449;12;12;15;21;16;64
2450;12;20;29;30;26;105
2451;12;21;24;21;15;81
2452;12;24;21;26;21;92
2453;12;14;15;20;13;62
2454;12;14;27;18;15;74
2455;12;19;25;19;16;79
2456;12;15;20;15;19;69
2457;12;14;22;16;18;70
2458;12;15;19;21;16;71
2459;12;13;18;10;12;53
2460;12;18;16;12;12;58
2461;12;15;14;15;23;67
2462;12;19;16;15;10;60
2463;12;17;30;19;12;78
2464;12;15;17;22;21;75
2465;12;12;17;21;11;61
2466;12;10;12;20;17;59
2467;12;12;13;12;6;43
2468;12;8;20;16;8;52
2469;12;8;21;15;18;62
2470;12;8;19;11;11;49
2471;12;12;8;10;10;40
2472;12;17;10;14;15;56
2473;12;12;9;12;10;43
2474;12;10;15;13;8;46
2475;12;8;15;8;11;42
2476;12;13;10;13;9;45
2477;12;9;10;18;15;52
2478;12;7;11;13;9;40
2479;12;12;10;4;12;38
2480;12;8;11;10;12;41
2481;12;7;13;8;8;36
2482;12;5;20;14;9;48
2483;12;6;12;12;13;43
2484;12;8;10;9;14;41
2485;12;12;11;15;9;47
2486;12;11;12;17;12;52
2487;12;6;18;11;11;46
2488;12;13;9;14;8;44
2489;12;9;11;15;10;45
2490;12;8;17;15;11;51
2491;12;9;7;12;8;36
2492;12;6;14;4;9;33
2493;12;5;8;6;7;26
2494;12;7;4;8;11;30
2495;12;11;10;15;8;44
2496;12;6;16;5;9;36
2497;12;10;15;9;2;36
2498;12;7;9;10;5;31
2499;12;6;8;10;10;34
2500;12;9;14;9;13;45
2501;12;9;11;9;8;37
2502;12;9;8;10;7;34
2503;12;9;8;13;9;39
2504;12;9;10;6;5;30
2505;12;6;14;4;9;33
2506;12;10;12;6;9;37
2507;12;11;12;6;7;36
2508;12;10;10;7;10;37
2509;12;6;4;8;9;27
2510;12;6;10;7;12;35
2511;12;6;13;12;11;42
2512;12;15;15;11;6;47
2513;12;3;7;6;4;20
2514;12;3;6;12;10;31
2515;12;4;9;8;8;29
2516;12;7;8;16;10;41
2517;12;6;13;8;6;33
2518;12;8;12;12;7;39
2519;12;7;4;10;8;29
2520;12;9;8;12;10;39
2521;12;6;8;12;9;35
2522;12;4;6;10;9;29
2523;12;9;13;6;9;37
2524;12;8;4;8;6;26
2525;12;7;10;2;8;27
2526;12;9;13;8;12;42
2527;12;10;9;7;13;39
2528;12;5;18;7;7;37
2529;12;5;8;8;7;28
2530;12;7;4;6;6;23
2531;12;10;9;5;10;34
2532;12;7;9;8;5;29
2533;12;10;12;13;7;42
2534;12;4;9;7;10;30
2535;12;10;6;12;5;33
2536;12;7;12;11;11;41
2537;12;5;7;9;7;28
2538;12;7;12;11;5;35
2539;12;8;11;13;6;38
2540;12;7;4;11;8;30
2541;12;2;13;10;4;29
2542;12;8;14;12;7;41
2543;12;7;13;7;11;38
2544;12;9;7;11;9;36
2545;12;8;9;12;9;38
2546;12;12;8;12;13;45
2547;12;4;8;6;6;24
2548;12;9;9;18;10;46
2549;12;10;11;7;9;37
2550;12;10;10;4;9;33
2551;12;1;9;6;10;26
2552;12;6;12;6;13;37
2553;12;12;9;10;11;42
2554;12;6;12;8;5;31
2555;12;8;8;15;8;39
2556;12;5;6;10;7;28
2557;12;5;8;11;9;33
2558;12;5;3;2;8;18
2559;12;5;11;8;8;32
2560;12;3;11;13;11;38
2561;12;4;11;10;8;33
2562;12;7;6;9;3;25
2563;12;8;6;8;5;27
2564;12;6;8;8;9;31
2565;12;7;7;7;9;30
2566;12;11;6;8;10;35
2567;12;4;7;4;5;20
2568;12;9;2;7;12;30
2569;12;6;9;6;4;25
2570;12;11;10;9;9;39
2571;12;9;9;9;8;35
2572;12;6;7;10;9;32
2573;12;9;4;5;5;23
2574;12;7;9;9;8;33
2575;12;8;6;12;2;28
2576;12;6;11;5;10;32
2577;12;6;14;5;9;34
2578;12;9;8;10;5;32
2579;12;8;3;7;4;22
2580;12;8;7;8;9;32
2581;12;7;11;6;6;30
2582;12;5;10;7;9;31
2583;12;3;11;12;4;30
2584;12;12;5;7;10;34
2585;12;4;5;7;4;20
2586;12;5;5;10;4;24
2587;12;7;11;9;8;35
2588;12;6;8;4;6;24
2589;12;8;1;4;7;20
2590;12;9;4;5;11;29
2591;12;4;7;9;12;32
2592;12;6;12;6;6;30
2593;12;6;5;9;11;31
2594;12;6;10;5;10;31
2595;12;5;3;6;8;22
2596;12;6;11;7;6;30
2597;12;3;8;8;9;28
2598;12;6;13;4;11;34
2599;12;6;9;8;8;31
2600;12;5;10;13;9;37
2601;12;5;8;7;10;30
2602;12;12;6;5;4;27
2603;12;8;11;5;8;32
2604;12;8;6;12;8;34
2605;12;7;11;13;7;38
2606;12;7;4;5;7;23
2607;12;7;10;7;9;33
2608;12;8;16;6;4;34
2609;12;10;5;8;3;26
2610;12;7;6;8;6;27
2611;12;8;13;9;7;37
2612;12;12;6;10;8;36
2613;12;5;11;3;5;24
2614;12;4;10;7;7;28
2615;12;9;8;11;9;37
2616;12;10;7;6;5;28
2617;12;14;5;5;9;33
2618;12;3;10;6;6;25
2619;12;6;8;12;7;33
2620;12;10;9;12;4;35
2621;12;6;6;6;9;27
2622;12;6;7;7;8;28
2623;12;10;9;6;7;32
2624;12;3;11;6;4;24
2625;12;4;10;11;4;29
2626;12;2;7;9;10;28
2627;12;4;9;6;3;22
2628;12;6;5;8;8;27
2629;12;8;4;9;11;32
2630;12;5;13;7;6;31
2631;12;6;7;15;2;30
2632;12;6;9;7;10;32
2633;12;5;7;13;13;38
2634;12;7;7;11;4;29
2635;12;4;6;8;5;23
2636;12;5;5;10;9;29
2637;12;6;7;9;9;31
2638;12;7;6;9;10;32
2639;12;4;3;2;8;17
2640;12;6;10;11;4;31
2641;12;4;10;10;8;32
2642;12;7;7;14;9;37
2643;12;8;2;8;5;23
2644;12;11;12;3;6;32
2645;12;8;8;14;8;38
2646;12;5;12;8;6;31
2647;12;4;4;12;7;27
2648;12;6;7;8;9;30
2649;12;10;8;6;9;33
2650;12;7;5;9;7;28
2651;12;4;10;9;6;29
2652;12;7;6;7;9;29
2653;12;3;8;10;10;31
2654;12;4;15;14;8;41
2655;12;7;7;6;9;29
2656;12;6;7;7;13;33
2657;12;6;6;7;10;29
2658;12;10;8;8;9;35
2659;12;12;9;6;9;36
2660;12;2;6;11;10;29
2661;12;5;2;4;8;19
2662;12;9;12;3;10;34
2663;12;6;9;7;8;30
2664;12;10;10;4;6;30
2665;12;6;8;7;8;29
2666;12;8;5;14;4;31
2667;12;3;9;7;1;20
2668;12;3;6;4;9;22
2669;12;1;4;7;10;22
2670;12;7;8;7;7;29
2671;12;4;6;9;6;25
2672;12;10;7;10;4;31
2673;12;5;7;16;7;35
2674;12;10;6;12;7;35
2675;12;8;8;4;8;28
2676;12;7;10;15;8;40
2677;12;9;11;12;2;34
2678;12;8;7;6;8;29
2679;12;4;4;8;12;28
2680;12;7;15;5;9;36
2681;12;6;11;3;9;29
2682;12;11;7;7;4;29
2683;12;5;5;8;10;28
2684;12;15;13;11;4;43
2685;12;11;6;8;5;30
2686;12;7;9;12;6;34
2687;12;6;7;4;5;22
2688;12;13;6;9;9;37
2689;12;7;11;3;8;29
2690;12;6;10;8;8;32
2691;12;9;4;4;8;25
2692;12;5;11;7;4;27
2693;12;9;6;8;5;28
2694;12;10;12;16;9;47
2695;12;5;3;9;9;26
2696;12;8;3;9;5;25
2697;12;9;6;5;6;26
2698;12;3;10;7;6;26
2699;12;3;10;9;7;29
2700;12;4;9;5;4;22
2701;12;12;8;6;10;36
2702;12;8;5;6;8;27
2703;12;11;3;8;8;30
2704;12;8;8;5;6;27
2705;12;7;15;10;6;38
2706;12;8;4;8;8;28
2707;12;4;8;6;6;24
2708;12;7;4;8;12;31
2709;12;5;9;5;7;26
2710;12;8;13;6;5;32
2711;12;8;4;11;10;33
2712;12;6;8;9;8;31
2713;12;12;3;8;7;30
2714;12;5;2;8;8;23
2715;12;10;9;9;4;32
2716;12;6;7;5;8;26
2717;12;7;7;7;5;26
2718;12;11;7;8;8;34
2719;12;6;7;7;3;23
2720;12;5;14;6;6;31
2721;12;3;3;8;3;17
2722;12;5;5;3;5;18
2723;12;4;11;13;9;37
2724;12;4;3;10;6;23
2725;12;4;10;10;7;31
2726;12;8;6;10;7;31
2727;12;10;9;13;4;36
2728;12;10;9;3;7;29
2729;12;6;8;9;8;31
2730;12;5;6;11;7;29
2731;12;5;4;9;10;28
2732;12;5;9;11;8;33
2733;12;14;9;6;5;34
2734;12;8;7;5;12;32
2735;12;5;6;12;7;30
2736;12;5;14;5;9;33
2737;12;7;9;11;13;40
2738;12;7;8;13;4;32
2739;12;4;7;8;8;27
2740;12;11;8;5;8;32
2741;12;2;6;6;8;22
2742;12;2;5;6;9;22
2743;12;5;5;8;14;32
2744;12;5;6;12;3;26
2745;12;4;8;9;9;30
2746;12;6;4;7;4;21
2747;12;7;5;8;13;33
2748;12;2;5;5;4;16
2749;12;6;8;7;12;33
2750;12;6;3;10;8;27
2751;12;11;5;11;8;35
2752;12;7;8;5;7;27
2753;12;2;11;5;10;28
2754;12;6;3;6;7;22
2755;12;5;8;7;4;24
2756;12;7;12;8;7;34
2757;12;5;7;8;4;24
2758;12;11;5;6;7;29
2759;12;9;9;10;6;34
2760;12;10;7;4;5;26
2761;12;6;13;12;10;41
2762;12;5;11;5;4;25
2763;12;6;7;8;5;26
2764;12;11;14;4;8;37
2765;12;7;9;3;6;25
2766;12;3;4;8;4;19
2767;12;9;2;5;8;24
2768;12;7;8;13;5;33
2769;12;2;4;5;12;23
2770;12;7;1;8;5;21
2771;12;8;6;7;5;26
2772;12;8;10;10;8;36
2773;12;2;9;8;8;27
2774;12;5;7;8;7;27
2775;12;8;10;10;11;39
2776;12;5;7;8;5;25
2777;12;7;3;9;8;27
2778;12;5;7;8;6;26
2779;12;11;13;7;4;35
2780;12;7;4;7;4;22
2781;12;9;10;3;4;26
2782;12;5;3;10;10;28
2783;12;7;5;6;10;28
2784;12;7;5;8;10;30
2785;12;3;5;11;7;26
2786;12;6;10;8;9;33
2787;12;6;4;3;11;24
2788;12;10;7;9;5;31
2789;12;9;4;10;9;32
2790;12;6;9;6;10;31
2791;12;7;11;12;7;37
2792;12;5;9;19;6;39
2793;12;4;7;2;8;21
2794;12;8;7;10;3;28
2795;14;243;257;259;247;1006
2796;14;206;210;216;197;829
2797;14;184;227;230;177;818
2798;14;190;199;197;167;753
2799;14;154;189;196;172;711
2800;14;169;152;181;197;699
2801;14;143;157;184;178;662
2802;14;148;181;191;181;701
2803;14;146;167;153;157;623
2804;14;122;179;150;150;601
2805;14;141;155;139;155;590
2806;14;115;148;134;121;518
2807;14;118;135;122;147;522
2808;14;104;123;129;146;502
2809;14;113;126;113;104;456
2810;14;126;122;104;127;479
2811;14;106;108;103;94;411
2812;14;73;109;103;88;373
2813;14;93;103;105;101;402
2814;14;86;103;86;95;370
2815;14;93;110;89;102;394
2816;14;78;87;84;85;334
2817;14;54;76;81;87;298
2818;14;65;100;93;71;329
2819;14;76;90;75;69;310
2820;14;56;69;85;69;279
2821;14;62;56;69;59;246
2822;14;66;62;55;67;250
2823;14;64;62;65;64;255
2824;14;42;48;73;66;229
2825;14;51;66;70;61;248
2826;14;40;56;48;60;204
2827;14;53;60;59;56;228
2828;14;35;47;35;53;170
2829;14;44;41;57;42;184
2830;14;50;45;49;48;192
2831;14;50;39;50;34;173
2832;14;38;40;54;54;186
2833;14;34;45;39;45;163
2834;14;35;44;53;45;177
2835;14;36;47;44;33;160
2836;14;27;32;42;35;136
2837;14;27;38;35;31;131
2838;14;20;32;42;40;134
2839;14;33;27;27;37;124
2840;14;28;26;33;33;120
2841;14;28;21;31;42;122
2842;14;31;31;30;25;117
2843;14;33;30;29;31;123
2844;14;28;30;28;31;117
2845;14;29;16;36;21;102
2846;14;20;22;24;22;88
2847;14;29;24;24;23;100
2848;14;22;31;20;23;96
2849;14;18;30;22;23;93
2850;14;20;22;22;28;92
2851;14;23;24;28;17;92
2852;14;17;17;24;28;86
2853;14;21;25;17;14;77
2854;14;20;21;21;24;86
2855;14;23;30;18;19;90
2856;14;20;22;32;20;94
2857;14;19;25;19;19;82
2858;14;14;22;19;23;78
2859;14;21;19;14;18;72
2860;14;18;22;15;14;69
2861;14;10;16;15;14;55
2862;14;17;14;21;16;68
2863;14;8;18;21;19;66
2864;14;15;12;18;15;60
2865;14;12;19;15;14;60
2866;14;15;15;18;13;61
2867;14;8;17;20;17;62
2868;14;9;20;18;14;61
2869;14;12;12;16;15;55
2870;14;9;16;12;6;43
2871;14;8;13;12;9;42
2872;14;7;12;17;7;43
2873;14;8;11;15;13;47
2874;14;7;14;14;18;53
2875;14;10;11;14;7;42
2876;14;11;11;13;14;49
2877;14;10;9;13;14;46
2878;14;11;15;10;13;49
2879;14;14;8;9;10;41
2880;14;7;7;8;9;31
2881;14;13;5;12;11;41
2882;14;9;15;11;9;44
2883;14;12;16;15;10;53
2884;14;13;5;11;9;38
2885;14;8;16;10;10;44
2886;14;10;9;11;13;43
2887;14;6;8;12;14;40
2888;14;11;7;8;11;37
2889;14;13;8;16;8;45
2890;14;8;4;7;8;27
2891;14;6;10;9;9;34
2892;14;13;8;10;6;37
2893;14;14;15;12;7;48
2894;14;10;7;14;12;43
2895;14;4;10;7;6;27
2896;14;2;5;17;7;31
2897;14;12;12;10;10;44
2898;14;4;14;6;10;34
2899;14;8;8;6;9;31
2900;14;8;14;15;6;43
2901;14;5;11;12;11;39
2902;14;3;9;11;10;33
2903;14;13;12;13;5;43
2904;14;10;8;11;7;36
2905;14;6;5;6;10;27
2906;14;7;11;9;4;31
2907;14;9;14;9;10;42
2908;14;3;12;7;6;28
2909;14;11;11;12;9;43
2910;14;9;10;13;3;35
2911;14;8;5;7;8;28
2912;14;10;5;8;8;31
2913;14;6;11;11;7;35
2914;14;7;8;11;4;30
2915;14;9;9;10;7;35
2916;14;10;8;14;11;43
2917;14;10;8;8;7;33
2918;14;7;9;9;4;29
2919;14;9;10;13;5;37
2920;14;10;8;7;7;32
2921;14;8;6;11;11;36
2922;14;8;11;10;10;39
2923;14;9;9;14;8;40
2924;14;8;5;16;11;40
2925;14;13;4;8;12;37
2926;14;7;8;6;4;25
2927;14;4;8;21;9;42
2928;14;5;10;11;7;33
2929;14;5;12;10;9;36
2930;14;9;8;8;14;39
2931;14;11;6;7;2;26
2932;14;8;7;10;8;33
2933;14;6;11;8;7;32
2934;14;5;10;9;6;30
2935;14;7;9;6;9;31
2936;14;4;7;10;8;29
2937;14;5;11;7;10;33
2938;14;5;15;9;7;36
2939;14;6;8;10;7;31
2940;14;6;11;7;8;32
2941;14;7;7;13;6;33
2942;14;11;5;9;4;29
2943;14;8;7;13;10;38
2944;14;13;9;11;8;41
2945;14;6;9;10;10;35
2946;14;4;7;9;10;30
2947;14;8;9;8;15;40
2948;14;9;9;6;4;28
2949;14;14;12;8;7;41
2950;14;2;9;9;9;29
2951;14;10;6;8;16;40
2952;14;12;9;6;9;36
2953;14;9;7;9;10;35
2954;14;8;10;9;7;34
2955;14;6;11;7;8;32
2956;14;6;17;6;6;35
2957;14;6;6;7;4;23
2958;14;6;5;4;5;20
2959;14;5;5;6;9;25
2960;14;5;11;10;6;32
2961;14;5;7;8;13;33
2962;14;5;5;12;7;29
2963;14;2;6;5;5;18
2964;14;5;14;6;7;32
2965;14;8;7;13;10;38
2966;14;9;10;11;10;40
2967;14;5;11;8;5;29
2968;14;5;7;6;10;28
2969;14;8;8;13;10;39
2970;14;8;8;5;11;32
2971;14;7;7;9;8;31
2972;14;3;8;9;7;27
2973;14;5;10;4;7;26
2974;14;5;13;11;14;43
2975;14;10;5;12;7;34
2976;14;6;11;14;3;34
2977;14;7;8;4;10;29
2978;14;5;10;9;6;30
2979;14;3;6;9;4;22
2980;14;6;11;5;10;32
2981;14;11;9;11;8;39
2982;14;1;7;9;11;28
2983;14;8;5;4;12;29
2984;14;9;10;9;4;32
2985;14;8;7;5;5;25
2986;14;6;9;8;9;32
2987;14;6;6;10;7;29
2988;14;9;3;9;12;33
2989;14;7;15;6;9;37
2990;14;10;6;5;14;35
2991;14;8;11;10;6;35
2992;14;7;6;6;9;28
2993;14;4;4;8;9;25
2994;14;3;5;11;9;28
2995;14;6;11;6;3;26
2996;14;7;14;8;6;35
2997;14;8;7;4;6;25
2998;14;7;9;11;4;31
2999;14;6;6;8;9;29
3000;14;9;5;10;5;29
3001;14;7;13;11;11;42
3002;14;6;11;7;9;33
3003;14;8;7;7;9;31
3004;14;8;10;9;7;34
3005;14;7;8;11;3;29
3006;14;5;8;7;7;27
3007;14;3;7;8;10;28
3008;14;8;5;3;8;24
3009;14;7;7;9;11;34
3010;14;15;10;8;9;42
3011;14;11;6;7;7;31
3012;14;9;9;2;8;28
3013;14;9;11;9;9;38
3014;14;5;10;5;7;27
3015;14;6;13;8;8;35
3016;14;4;8;8;9;29
3017;14;4;10;12;3;29
3018;14;10;6;5;4;25
3019;14;5;8;11;10;34
3020;14;10;9;4;8;31
3021;14;5;13;7;12;37
3022;14;6;4;11;6;27
3023;14;10;4;8;12;34
3024;14;9;15;3;8;35
3025;14;8;10;8;6;32
3026;14;6;10;4;6;26
3027;14;10;7;4;8;29
3028;14;3;5;11;18;37
3029;14;7;9;7;5;28
3030;14;13;3;6;9;31
3031;14;8;3;9;4;24
3032;14;7;4;10;6;27
3033;14;6;7;7;13;33
3034;14;7;13;8;6;34
3035;14;3;6;8;13;30
3036;14;4;7;5;8;24
3037;14;2;8;9;3;22
3038;14;7;12;5;10;34
3039;14;2;8;8;5;23
3040;14;9;9;8;12;38
3041;14;6;7;8;9;30
3042;14;10;8;8;9;35
3043;14;8;4;13;5;30
3044;14;12;5;7;5;29
3045;14;5;4;8;7;24
3046;14;3;6;4;7;20
3047;14;8;6;13;10;37
3048;14;11;9;5;5;30
3049;14;8;9;10;10;37
3050;14;6;7;12;7;32
3051;14;3;5;4;6;18
3052;14;4;7;5;6;22
3053;14;5;10;11;6;32
3054;14;5;7;8;14;34
3055;14;4;6;8;7;25
3056;14;8;5;10;12;35
3057;14;14;13;6;5;38
3058;14;4;8;7;8;27
3059;14;4;9;5;5;23
3060;14;4;11;6;7;28
3061;14;3;7;5;7;22
3062;14;6;7;9;4;26
3063;14;5;7;4;11;27
3064;14;7;5;7;5;24
3065;14;5;11;4;8;28
3066;14;2;6;5;14;27
3067;14;3;8;12;2;25
3068;14;5;7;4;13;29
3069;14;9;11;8;6;34
3070;14;6;8;10;8;32
3071;14;9;4;7;5;25
3072;14;4;9;11;8;32
3073;14;7;5;11;6;29
3074;14;7;15;8;8;38
3075;14;6;4;7;6;23
3076;14;5;10;5;11;31
3077;14;6;7;5;8;26
3078;14;4;6;8;4;22
3079;14;5;12;12;6;35
3080;14;9;9;7;5;30
3081;14;5;5;15;6;31
3082;14;5;7;6;11;29
3083;14;4;4;10;13;31
3084;14;5;9;10;7;31
3085;14;9;6;17;9;41
3086;14;10;6;8;9;33
3087;14;7;5;8;9;29
3088;14;5;10;6;10;31
3089;14;11;10;8;10;39
3090;14;6;11;8;6;31
3091;14;11;10;5;7;33
3092;14;8;4;7;9;28
3093;14;4;10;7;4;25
3094;14;5;10;13;7;35
3095;14;3;5;10;6;24
3096;14;14;10;8;2;34
3097;14;5;13;6;8;32
3098;14;12;11;11;5;39
3099;14;6;8;8;5;27
3100;14;4;8;8;9;29
3101;14;5;9;9;8;31
3102;14;11;12;14;6;43
3103;14;4;7;6;11;28
3104;14;5;9;6;6;26
3105;14;12;8;9;6;35
3106;14;6;6;7;6;25
3107;14;7;12;11;5;35
3108;14;5;5;3;9;22
3109;14;4;8;9;8;29
3110;14;13;7;14;9;43
3111;14;4;12;12;7;35
3112;14;7;12;7;7;33
3113;14;6;8;4;18;36
3114;14;7;5;7;3;22
3115;14;2;5;6;8;21
3116;14;5;11;5;9;30
3117;14;10;5;9;10;34
3118;14;4;4;9;5;22
3119;14;4;8;16;13;41
3120;14;7;8;12;9;36
3121;14;7;8;5;5;25
3122;14;6;7;7;5;25
3123;14;10;4;8;11;33
3124;14;4;8;4;11;27
3125;14;10;9;8;6;33
3126;14;5;6;9;12;32
3127;14;11;5;5;5;26
3128;14;8;9;11;3;31
3129;14;9;14;7;4;34
3130;14;12;13;6;8;39
3131;14;7;6;8;8;29
3132;14;9;9;4;4;26
3133;14;8;12;9;5;34
3134;14;5;9;8;5;27
3135;14;7;5;9;7;28
3136;14;4;7;4;8;23
3137;14;5;9;5;3;22
3138;14;3;5;11;7;26
3139;14;9;9;3;8;29
3140;14;7;7;8;8;30
3141;14;11;9;16;9;45
3142;14;10;8;8;9;35
3143;14;4;7;7;6;24
3144;14;6;2;8;10;26
3145;14;3;9;7;9;28
3146;14;9;7;9;5;30
3147;14;8;10;9;5;32
3148;14;9;12;11;15;47
3149;14;5;3;10;11;29
3150;14;7;7;6;8;28
3151;14;7;7;14;3;31
3152;14;3;8;4;5;20
3153;14;6;3;7;4;20
3154;14;5;7;12;9;33
3155;14;5;7;2;6;20
3156;14;9;9;9;5;32
3157;14;2;8;5;11;26
3158;14;4;8;12;6;30
3159;14;5;7;8;9;29
3160;14;11;7;6;5;29
3161;14;8;6;4;11;29
3162;14;9;10;7;8;34
3163;14;5;9;3;6;23
3164;14;8;10;10;3;31
3165;14;4;9;8;5;26
3166;14;4;6;9;9;28
3167;14;11;4;4;7;26
3168;14;8;13;1;6;28
3169;14;3;5;9;8;25
3170;14;7;2;3;11;23
3171;14;4;5;9;7;25
3172;14;5;5;11;5;26
3173;14;3;11;8;8;30
3174;14;2;6;7;11;26
3175;14;10;13;9;11;43
3176;14;5;8;7;8;28
3177;14;7;13;10;10;40
3178;14;5;13;4;6;28
3179;14;12;6;5;9;32
3180;14;4;11;7;8;30
3181;14;6;12;6;10;34
3182;14;10;5;8;5;28
3183;14;4;6;9;9;28
3184;14;2;13;6;9;30
3185;14;8;15;6;6;35
3186;14;4;5;10;8;27
3187;14;6;5;7;12;30
3188;14;7;6;14;5;32
3189;14;6;9;9;9;33
3190;14;5;9;4;3;21
3191;14;9;10;9;4;32
3192;14;5;8;10;7;30
3193;14;8;6;8;7;29
3194;14;5;9;6;10;30
3195;14;4;10;3;8;25
3196;14;7;8;5;7;27
3197;14;5;11;10;5;31
3198;14;30;10;2;16;58
3199;14;6;7;11;2;26
3200;14;6;5;10;10;31
3201;14;7;5;5;6;23
3202;14;14;9;8;11;42
3203;14;6;5;6;10;27
3204;14;4;7;7;9;27
3205;14;4;8;7;5;24
3206;16;567;586;581;579;2313
3207;16;496;536;521;495;2048
3208;16;532;533;509;490;2064
3209;16;463;512;480;477;1932
3210;16;454;498;459;453;1864
3211;16;415;446;465;451;1777
3212;16;433;440;414;375;1662
3213;16;406;430;415;399;1650
3214;16;386;411;376;379;1552
3215;16;412;399;401;394;1606
3216;16;337;367;362;368;1434
3217;16;331;354;342;343;1370
3218;16;317;360;364;351;1392
3219;16;299;311;329;315;1254
3220;16;271;290;304;299;1164
3221;16;274;302;314;282;1172
3222;16;227;273;276;298;1074
3223;16;254;299;306;236;1095
3224;16;225;259;279;265;1028
3225;16;237;278;266;253;1034
3226;16;233;247;251;228;959
3227;16;206;234;215;243;898
3228;16;185;224;225;188;822
3229;16;197;227;200;207;831
3230;16;207;202;187;221;817
3231;16;158;222;207;182;769
3232;16;161;176;176;185;698
3233;16;153;199;180;176;708
3234;16;155;180;163;172;670
3235;16;147;177;165;149;638
3236;16;148;166;138;156;608
3237;16;128;154;148;144;574
3238;16;132;144;157;131;564
3239;16;123;131;124;119;497
3240;16;115;157;119;129;520
3241;16;116;120;119;116;471
3242;16;111;123;116;109;459
3243;16;117;134;118;99;468
3244;16;90;105;102;86;383
3245;16;101;83;106;104;394
3246;16;83;110;100;96;389
3247;16;85;96;91;95;367
3248;16;100;83;78;88;349
3249;16;74;74;79;80;307
3250;16;71;97;90;87;345
3251;16;68;84;94;89;335
3252;16;67;77;77;75;296
3253;16;78;63;81;75;297
3254;16;69;67;68;71;275
3255;16;68;73;69;66;276
3256;16;45;73;63;71;252
3257;16;58;57;71;51;237
3258;16;52;61;63;71;247
3259;16;51;60;66;58;235
3260;16;58;50;65;56;229
3261;16;40;66;48;54;208
3262;16;46;42;58;61;207
3263;16;45;49;51;47;192
3264;16;53;28;61;37;179
3265;16;51;42;47;50;190
3266;16;28;39;47;39;153
3267;16;37;54;48;38;177
3268;16;31;39;46;54;170
3269;16;34;34;45;38;151
3270;16;34;39;40;33;146
3271;16;22;36;44;39;141
3272;16;41;40;38;33;152
3273;16;41;31;31;28;131
3274;16;21;26;28;35;110
3275;16;27;30;35;25;117
3276;16;24;34;29;29;116
3277;16;21;35;27;24;107
3278;16;21;39;34;32;126
3279;16;23;31;31;21;106
3280;16;27;22;18;28;95
3281;16;19;23;24;15;81
3282;16;16;30;26;18;90
3283;16;24;25;27;22;98
3284;16;20;25;26;27;98
3285;16;19;25;26;23;93
3286;16;24;27;33;25;109
3287;16;15;22;31;19;87
3288;16;20;15;18;19;72
3289;16;18;26;16;19;79
3290;16;25;14;27;28;94
3291;16;31;20;20;16;87
3292;16;20;24;14;23;81
3293;16;10;19;20;21;70
3294;16;25;15;20;12;72
3295;16;15;18;24;18;75
3296;16;16;13;15;12;56
3297;16;12;11;16;21;60
3298;16;11;17;14;17;59
3299;16;15;11;11;14;51
3300;16;13;16;18;20;67
3301;16;16;16;16;17;65
3302;16;11;10;9;10;40
3303;16;12;17;13;20;62
3304;16;11;20;23;16;70
3305;16;18;20;15;19;72
3306;16;14;15;12;19;60
3307;16;8;13;15;9;45
3308;16;14;23;13;15;65
3309;16;16;10;17;17;60
3310;16;15;10;11;8;44
3311;16;11;8;15;14;48
3312;16;13;16;13;16;58
3313;16;7;14;14;4;39
3314;16;7;17;11;15;50
3315;16;8;14;11;13;46
3316;16;11;14;11;7;43
3317;16;10;16;11;12;49
3318;16;9;17;8;12;46
3319;16;7;15;16;13;51
3320;16;12;16;17;11;56
3321;16;8;12;9;6;35
3322;16;7;17;15;15;54
3323;16;6;10;15;11;42
3324;16;4;3;14;11;32
3325;16;4;8;8;14;34
3326;16;7;15;9;9;40
3327;16;16;19;12;11;58
3328;16;15;13;10;10;48
3329;16;11;14;13;11;49
3330;16;19;13;6;9;47
3331;16;6;4;10;11;31
3332;16;7;16;14;6;43
3333;16;9;8;7;14;38
3334;16;9;16;9;13;47
3335;16;7;5;11;10;33
3336;16;3;14;6;11;34
3337;16;8;10;9;10;37
3338;16;12;15;11;14;52
3339;16;9;9;8;17;43
3340;16;8;15;12;9;44
3341;16;8;7;7;8;30
3342;16;14;2;9;12;37
3343;16;5;16;13;7;41
3344;16;13;15;10;3;41
3345;16;11;9;12;15;47
3346;16;7;10;15;8;40
3347;16;7;7;3;7;24
3348;16;13;7;15;12;47
3349;16;4;12;12;10;38
3350;16;7;8;10;8;33
3351;16;6;8;9;11;34
3352;16;3;9;7;10;29
3353;16;6;11;8;10;35
3354;16;4;6;14;7;31
3355;16;11;8;5;15;39
3356;16;12;7;10;7;36
3357;16;7;18;12;5;42
3358;16;11;11;13;8;43
3359;16;8;8;13;12;41
3360;16;3;13;6;6;28
3361;16;8;6;8;9;31
3362;16;17;12;8;8;45
3363;16;11;7;19;7;44
3364;16;10;8;14;5;37
3365;16;3;7;7;9;26
3366;16;12;8;6;12;38
3367;16;10;11;10;11;42
3368;16;7;14;7;7;35
3369;16;15;7;10;10;42
3370;16;11;5;5;9;30
3371;16;6;11;14;7;38
3372;16;7;9;8;5;29
3373;16;12;10;14;13;49
3374;16;8;15;17;12;52
3375;16;13;5;18;8;44
3376;16;8;16;16;11;51
3377;16;9;12;6;7;34
3378;16;10;10;11;10;41
3379;16;6;10;6;12;34
3380;16;8;17;8;15;48
3381;16;6;10;10;13;39
3382;16;10;9;11;5;35
3383;16;9;6;10;7;32
3384;16;9;7;6;9;31
3385;16;11;10;14;13;48
3386;16;8;8;6;6;28
3387;16;6;3;6;12;27
3388;16;7;9;16;8;40
3389;16;14;8;8;5;35
3390;16;3;8;13;8;32
3391;16;11;8;10;7;36
3392;16;5;11;11;13;40
3393;16;12;7;11;12;42
3394;16;7;5;12;5;29
3395;16;9;9;5;19;42
3396;16;8;10;7;9;34
3397;16;8;11;12;6;37
3398;16;9;14;4;8;35
3399;16;4;7;12;9;32
3400;16;5;5;10;6;26
3401;16;7;8;6;7;28
3402;16;10;8;7;11;36
3403;16;8;15;13;4;40
3404;16;5;6;10;6;27
3405;16;13;10;10;7;40
3406;16;5;13;11;16;45
3407;16;3;15;5;6;29
3408;16;9;9;12;12;42
3409;16;14;8;13;10;45
3410;16;4;12;9;7;32
3411;16;4;10;10;11;35
3412;16;5;7;13;8;33
3413;16;8;10;3;10;31
3414;16;7;7;10;3;27
3415;16;6;8;9;14;37
3416;16;5;9;6;10;30
3417;16;6;13;5;8;32
3418;16;6;14;11;11;42
3419;16;9;6;14;7;36
3420;16;7;2;7;7;23
3421;16;8;8;7;12;35
3422;16;3;5;9;6;23
3423;16;7;10;7;17;41
3424;16;9;6;9;8;32
3425;16;6;8;10;10;34
3426;16;5;13;8;12;38
3427;16;5;5;13;9;32
3428;16;7;12;4;5;28
3429;16;7;7;11;11;36
3430;16;10;10;10;7;37
3431;16;7;5;8;6;26
3432;16;13;8;8;6;35
3433;16;9;5;12;9;35
3434;16;7;12;7;8;34
3435;16;6;8;12;12;38
3436;16;6;7;11;10;34
3437;16;5;5;7;14;31
3438;16;7;8;10;8;33
3439;16;9;6;15;5;35
3440;16;6;7;5;8;26
3441;16;9;12;4;16;41
3442;16;5;7;6;11;29
3443;16;0;5;11;8;24
3444;16;6;5;10;6;27
3445;16;5;11;12;4;32
3446;16;9;11;13;9;42
3447;16;7;9;11;7;34
3448;16;13;3;12;8;36
3449;16;8;6;7;10;31
3450;16;6;9;9;14;38
3451;16;7;11;13;11;42
3452;16;9;11;11;8;39
3453;16;8;12;7;9;36
3454;16;11;6;8;11;36
3455;16;13;5;13;11;42
3456;16;7;9;6;6;28
3457;16;7;8;14;9;38
3458;16;9;10;12;6;37
3459;16;11;9;10;6;36
3460;16;5;7;14;5;31
3461;16;12;10;8;13;43
3462;16;14;15;9;11;49
3463;16;4;3;13;7;27
3464;16;8;5;9;8;30
3465;16;10;8;15;7;40
3466;16;4;11;13;7;35
3467;16;13;8;13;6;40
3468;16;7;13;3;12;35
3469;16;2;7;7;12;28
3470;16;7;18;11;8;44
3471;16;8;8;10;7;33
3472;16;6;4;5;8;23
3473;16;9;7;11;12;39
3474;16;8;13;8;8;37
3475;16;6;7;11;9;33
3476;16;4;8;8;5;25
3477;16;10;12;9;5;36
3478;16;9;5;12;10;36
3479;16;7;10;16;7;40
3480;16;10;13;6;9;38
3481;16;9;6;11;7;33
3482;16;7;5;6;6;24
3483;16;12;9;13;9;43
3484;16;2;9;6;13;30
3485;16;4;8;4;7;23
3486;16;13;6;7;11;37
3487;16;8;6;11;6;31
3488;16;7;10;8;5;30
3489;16;13;15;10;5;43
3490;16;4;15;11;3;33
3491;16;8;10;7;5;30
3492;16;7;6;12;10;35
3493;16;7;5;9;9;30
3494;16;13;10;13;9;45
3495;16;8;5;9;3;25
3496;16;4;19;17;9;49
3497;16;5;10;14;8;37
3498;16;7;6;10;11;34
3499;16;4;8;13;3;28
3500;16;10;9;11;8;38
3501;16;2;8;13;12;35
3502;16;5;7;7;6;25
3503;16;1;15;8;4;28
3504;16;7;7;16;8;38
3505;16;5;11;10;10;36
3506;16;7;7;4;7;25
3507;16;7;6;14;8;35
3508;16;4;13;8;7;32
3509;16;11;5;11;10;37
3510;16;11;6;10;4;31
3511;16;2;8;15;6;31
3512;16;6;9;9;10;34
3513;16;10;7;9;9;35
3514;16;8;7;10;6;31
3515;16;10;8;12;12;42
3516;16;9;6;13;4;32
3517;16;8;6;12;12;38
3518;16;10;13;6;3;32
3519;16;3;12;5;9;29
3520;16;8;8;13;14;43
3521;16;6;7;11;4;28
3522;16;9;10;7;9;35
3523;16;6;11;8;7;32
3524;16;9;11;13;7;40
3525;16;10;5;10;7;32
3526;16;6;11;15;10;42
3527;16;7;8;13;7;35
3528;16;7;9;8;5;29
3529;16;7;13;13;8;41
3530;16;6;6;4;9;25
3531;16;7;11;11;9;38
3532;16;6;10;11;7;34
3533;16;7;8;7;6;28
3534;16;9;11;7;8;35
3535;16;3;5;9;7;24
3536;16;7;8;5;11;31
3537;16;9;1;9;5;24
3538;16;9;6;6;10;31
3539;16;1;9;8;6;24
3540;16;9;16;11;10;46
3541;16;6;7;11;11;35
3542;16;11;5;11;7;34
3543;16;11;10;9;6;36
3544;16;8;7;6;9;30
3545;16;6;7;7;14;34
3546;16;6;11;8;8;33
3547;16;5;11;6;8;30
3548;16;9;5;7;9;30
3549;16;5;10;13;7;35
3550;16;8;11;8;17;44
3551;16;4;7;12;11;34
3552;16;5;8;8;8;29
3553;16;10;8;9;4;31
3554;16;4;4;11;14;33
3555;16;3;6;10;15;34
3556;16;5;7;12;9;33
3557;16;6;8;8;3;25
3558;16;9;13;16;12;50
3559;16;7;9;15;5;36
3560;16;8;14;8;11;41
3561;16;5;8;7;8;28
3562;16;4;5;14;12;35
3563;16;6;14;7;10;37
3564;16;5;11;8;7;31
3565;16;6;9;13;6;34
3566;16;7;10;5;5;27
3567;16;7;7;6;12;32
3568;16;6;8;4;4;22
3569;16;11;12;9;9;41
3570;16;4;8;9;14;35
3571;16;8;12;8;8;36
3572;16;8;4;10;6;28
3573;16;5;9;9;7;30
3574;16;7;10;13;5;35
3575;16;7;9;8;8;32
3576;16;8;3;10;10;31
3577;16;11;5;8;7;31
3578;16;5;17;5;8;35
3579;16;5;7;8;6;26
3580;16;6;7;8;6;27
3581;16;8;8;13;10;39
3582;16;3;11;11;5;30
3583;16;9;9;9;7;34
3584;16;7;4;8;8;27
3585;16;10;10;10;9;39
3586;16;16;4;10;9;39
3587;16;7;8;10;10;35
3588;16;3;5;13;10;31
3589;16;7;10;8;10;35
3590;16;4;10;8;5;27
3591;16;9;10;5;9;33
3592;16;10;6;9;15;40
3593;16;7;10;7;7;31
3594;16;5;11;9;7;32
3595;16;5;4;6;4;19
3596;16;10;10;7;8;35
3597;16;9;11;10;11;41
3598;16;7;9;11;9;36
3599;16;3;8;8;3;22
3600;16;7;8;7;6;28
3601;16;6;11;8;4;29
3602;16;7;12;11;14;44
3603;16;7;11;5;7;30
3604;16;8;2;7;9;26
3605;16;7;5;5;6;23
3606;16;10;6;7;9;32
3607;16;7;9;13;6;35
3608;16;10;14;13;10;47
3609;16;4;13;9;7;33
3610;16;9;6;7;7;29
3611;18;533;557;531;502;2123
3612;18;469;470;485;483;1907
3613;18;453;475;440;475;1843
3614;18;412;464;443;434;1753
3615;18;394;453;395;410;1652
3616;18;411;437;414;393;1655
3617;18;360;414;377;365;1516
3618;18;333;362;372;367;1434
3619;18;319;380;353;359;1411
3620;18;290;353;328;368;1339
3621;18;320;326;343;338;1327
3622;18;271;329;332;315;1247
3623;18;285;300;325;306;1216
3624;18;254;275;297;284;1110
3625;18;271;269;266;267;1073
3626;18;251;263;287;245;1046
3627;18;211;276;264;256;1007
3628;18;219;273;243;262;997
3629;18;224;252;232;251;959
3630;18;183;263;242;200;888
3631;18;197;226;213;221;857
3632;18;191;210;209;203;813
3633;18;180;177;198;167;722
3634;18;161;187;200;185;733
3635;18;166;159;187;182;694
3636;18;137;164;164;153;618
3637;18;140;178;161;151;630
3638;18;130;159;189;152;630
3639;18;129;148;143;168;588
3640;18;128;158;162;149;597
3641;18;134;143;136;170;583
3642;18;125;140;138;129;532
3643;18;102;108;146;130;486
3644;18;98;108;126;125;457
3645;18;104;96;127;113;440
3646;18;89;127;121;115;452
3647;18;96;103;95;103;397
3648;18;96;109;111;89;405
3649;18;85;85;93;99;362
3650;18;76;64;102;106;348
3651;18;78;92;79;87;336
3652;18;69;91;76;73;309
3653;18;65;67;77;74;283
3654;18;65;68;74;82;289
3655;18;60;74;75;66;275
3656;18;63;66;67;67;263
3657;18;53;70;62;58;243
3658;18;55;63;62;82;262
3659;18;57;65;69;69;260
3660;18;55;72;68;65;260
3661;18;59;51;56;52;218
3662;18;52;54;63;58;227
3663;18;51;54;69;54;228
3664;18;53;61;61;59;234
3665;18;50;61;62;58;231
3666;18;32;48;43;32;155
3667;18;37;38;55;31;161
3668;18;34;47;45;36;162
3669;18;30;49;30;43;152
3670;18;28;33;50;40;151
3671;18;42;47;46;57;192
3672;18;34;56;45;35;170
3673;18;27;35;31;31;124
3674;18;32;32;45;29;138
3675;18;29;47;40;33;149
3676;18;36;34;40;21;131
3677;18;31;38;34;30;133
3678;18;23;26;33;33;115
3679;18;24;23;29;23;99
3680;18;35;18;31;35;119
3681;18;19;33;38;30;120
3682;18;31;30;29;25;115
3683;18;21;28;28;36;113
3684;18;18;25;26;33;102
3685;18;24;33;27;17;101
3686;18;13;19;31;25;88
3687;18;20;27;34;23;104
3688;18;31;24;13;20;88
3689;18;15;24;15;18;72
3690;18;24;14;14;30;82
3691;18;20;25;20;30;95
3692;18;16;21;20;15;72
3693;18;18;19;22;15;74
3694;18;17;25;18;13;73
3695;18;16;28;15;14;73
3696;18;13;21;15;14;63
3697;18;17;14;17;19;67
3698;18;20;17;16;21;74
3699;18;15;15;15;16;61
3700;18;14;13;21;15;63
3701;18;20;19;21;17;77
3702;18;10;17;26;16;69
3703;18;15;17;16;17;65
3704;18;16;13;21;18;68
3705;18;10;21;11;19;61
3706;18;16;11;18;10;55
3707;18;14;26;15;15;70
3708;18;11;18;13;14;56
3709;18;10;16;18;16;60
3710;18;6;18;17;16;57
3711;18;9;20;19;15;63
3712;18;18;18;15;13;64
3713;18;10;11;12;15;48
3714;18;9;21;12;14;56
3715;18;14;13;21;10;58
3716;18;14;12;15;14;55
3717;18;12;9;19;10;50
3718;18;8;11;18;14;51
3719;18;14;17;6;13;50
3720;18;14;7;14;14;49
3721;18;12;16;13;8;49
3722;18;13;11;8;10;42
3723;18;9;13;10;8;40
3724;18;8;12;14;15;49
3725;18;7;15;15;16;53
3726;18;7;15;22;9;53
3727;18;10;15;10;10;45
3728;18;12;17;22;5;56
3729;18;7;9;13;12;41
3730;18;23;13;12;10;58
3731;18;7;13;12;18;50
3732;18;7;13;12;13;45
3733;18;10;10;10;8;38
3734;18;4;18;12;8;42
3735;18;4;7;14;14;39
3736;18;10;7;4;9;30
3737;18;10;13;16;10;49
3738;18;8;9;12;7;36
3739;18;7;9;12;10;38
3740;18;11;15;8;6;40
3741;18;12;10;16;8;46
3742;18;10;13;16;12;51
3743;18;7;11;10;10;38
3744;18;10;13;7;13;43
3745;18;11;10;13;7;41
3746;18;10;6;14;17;47
3747;18;7;10;11;12;40
3748;18;9;12;12;6;39
3749;18;4;12;12;3;31
3750;18;12;10;5;7;34
3751;18;8;11;9;11;39
3752;18;9;11;12;13;45
3753;18;8;12;11;13;44
3754;18;9;11;10;7;37
3755;18;15;5;10;12;42
3756;18;6;8;10;9;33
3757;18;7;4;9;6;26
3758;18;5;17;15;7;44
3759;18;6;8;12;6;32
3760;18;8;12;9;8;37
3761;18;10;14;19;7;50
3762;18;13;17;17;16;63
3763;18;11;5;14;9;39
3764;18;16;13;10;15;54
3765;18;5;16;11;10;42
3766;18;14;13;15;16;58
3767;18;8;9;10;10;37
3768;18;6;6;11;8;31
3769;18;7;18;8;10;43
3770;18;11;9;3;18;41
3771;18;6;13;13;10;42
3772;18;8;5;14;14;41
3773;18;9;9;7;8;33
3774;18;10;9;18;5;42
3775;18;4;8;7;10;29
3776;18;11;8;8;13;40
3777;18;11;13;10;12;46
3778;18;5;8;9;9;31
3779;18;9;9;8;6;32
3780;18;4;12;6;10;32
3781;18;7;11;13;12;43
3782;18;8;7;16;12;43
3783;18;8;4;5;6;23
3784;18;7;8;5;13;33
3785;18;11;14;9;8;42
3786;18;11;9;14;12;46
3787;18;11;7;11;4;33
3788;18;6;11;3;9;29
3789;18;7;9;7;11;34
3790;18;6;11;10;12;39
3791;18;8;8;11;13;40
3792;18;6;5;11;11;33
3793;18;8;9;9;15;41
3794;18;10;8;10;18;46
3795;18;7;10;11;9;37
3796;18;7;9;7;11;34
3797;18;7;8;8;7;30
3798;18;10;9;13;15;47
3799;18;3;13;10;17;43
3800;18;7;9;8;5;29
3801;18;11;7;10;10;38
3802;18;4;19;6;5;34
3803;18;12;13;9;12;46
3804;18;6;7;18;8;39
3805;18;11;11;10;7;39
3806;18;14;10;11;9;44
3807;18;7;12;6;11;36
3808;18;10;8;16;9;43
3809;18;9;17;19;13;58
3810;18;7;11;8;12;38
3811;18;9;17;14;7;47
3812;18;12;16;12;8;48
3813;18;12;11;10;14;47
3814;18;5;9;12;9;35
3815;18;5;14;12;7;38
3816;18;6;6;10;8;30
3817;18;11;7;15;12;45
3818;18;10;4;13;8;35
3819;18;10;12;4;11;37
3820;18;5;14;14;10;43
3821;18;14;16;8;6;44
3822;18;10;11;13;9;43
3823;18;13;7;6;8;34
3824;18;12;6;8;11;37
3825;18;16;14;11;5;46
3826;18;12;6;5;9;32
3827;18;6;13;12;11;42
3828;18;6;9;8;8;31
3829;18;9;10;8;9;36
3830;18;13;7;10;15;45
3831;18;6;9;11;11;37
3832;18;13;14;10;9;46
3833;18;3;9;14;10;36
3834;18;7;11;13;10;41
3835;18;6;11;7;6;30
3836;18;5;11;14;9;39
3837;18;7;5;7;8;27
3838;18;8;14;6;15;43
3839;18;6;12;12;5;35
3840;18;5;9;7;5;26
3841;18;6;7;10;7;30
3842;18;7;12;9;7;35
3843;18;6;12;8;6;32
3844;18;7;16;15;15;53
3845;18;7;10;7;11;35
3846;18;5;9;12;8;34
3847;18;16;11;6;11;44
3848;18;11;4;13;8;36
3849;18;9;10;16;10;45
3850;18;9;9;12;9;39
3851;18;6;8;14;9;37
3852;18;9;8;14;8;39
3853;18;7;3;6;11;27
3854;18;8;9;7;13;37
3855;18;7;9;9;15;40
3856;18;11;10;8;12;41
3857;18;12;5;15;10;42
3858;18;9;5;18;6;38
3859;18;7;9;10;12;38
3860;18;7;9;10;11;37
3861;18;5;14;14;7;40
3862;18;8;14;12;7;41
3863;18;8;8;7;11;34
3864;18;10;8;9;10;37
3865;18;11;18;7;7;43
3866;18;3;16;6;7;32
3867;18;6;10;11;6;33
3868;18;12;8;12;14;46
3869;18;4;11;9;7;31
3870;18;12;13;9;6;40
3871;18;12;8;8;12;40
3872;18;10;13;6;5;34
3873;18;5;7;8;8;28
3874;18;14;7;6;10;37
3875;18;13;9;8;5;35
3876;18;5;9;11;5;30
3877;18;14;13;12;15;54
3878;18;3;12;10;8;33
3879;18;10;5;8;6;29
3880;18;5;10;9;9;33
3881;18;7;12;9;7;35
3882;18;6;15;13;10;44
3883;18;3;10;4;3;20
3884;18;8;10;12;7;37
3885;18;8;9;10;13;40
3886;18;8;8;18;7;41
3887;18;5;15;11;12;43
3888;18;9;8;6;7;30
3889;18;4;9;8;14;35
3890;18;11;5;11;9;36
3891;18;13;14;10;4;41
3892;18;15;11;9;7;42
3893;18;10;11;12;9;42
3894;18;6;11;9;6;32
3895;18;9;6;15;8;38
3896;18;8;7;10;6;31
3897;18;8;6;6;8;28
3898;18;12;10;21;5;48
3899;18;4;9;7;10;30
3900;18;9;6;5;13;33
3901;18;12;8;11;11;42
3902;18;9;5;11;9;34
3903;18;4;10;11;10;35
3904;18;7;8;16;11;42
3905;18;8;9;8;13;38
3906;18;6;9;14;11;40
3907;18;8;8;11;8;35
3908;18;10;9;7;7;33
3909;18;13;9;9;12;43
3910;18;8;8;14;6;36
3911;18;7;12;6;11;36
3912;18;11;7;7;7;32
3913;18;10;11;11;4;36
3914;18;8;7;7;11;33
3915;18;10;12;6;10;38
3916;18;7;12;7;7;33
3917;18;6;12;11;12;41
3918;18;10;7;18;8;43
3919;18;9;9;5;9;32
3920;18;7;15;12;8;42
3921;18;11;8;7;8;34
3922;18;7;10;5;5;27
3923;18;11;5;11;13;40
3924;18;10;7;7;11;35
3925;18;7;11;8;12;38
3926;18;6;4;9;9;28
3927;18;10;4;8;7;29
3928;18;8;7;16;4;35
3929;18;11;14;12;13;50
3930;18;8;12;4;9;33
3931;18;3;12;9;15;39
3932;18;7;15;11;10;43
3933;18;8;8;14;8;38
3934;18;5;18;7;11;41
3935;18;10;14;6;8;38
3936;18;5;10;12;12;39
3937;18;7;10;8;9;34
3938;18;9;12;14;10;45
3939;18;11;8;12;8;39
3940;18;9;14;6;12;41
3941;18;7;5;8;11;31
3942;18;2;12;11;14;39
3943;18;10;6;14;7;37
3944;18;9;7;7;9;32
3945;18;7;14;8;7;36
3946;18;8;13;12;12;45
3947;18;9;7;13;4;33
3948;18;10;10;10;5;35
3949;18;7;13;8;8;36
3950;18;4;10;11;7;32
3951;18;8;8;12;8;36
3952;18;8;8;14;9;39
3953;18;7;11;9;16;43
3954;18;8;8;12;10;38
3955;18;8;10;9;9;36
3956;18;8;12;13;11;44
3957;18;4;11;12;11;38
3958;18;7;10;5;6;28
3959;18;8;8;10;7;33
3960;18;8;7;9;6;30
3961;18;2;7;6;12;27
3962;18;9;11;9;5;34
3963;18;8;12;12;12;44
3964;18;7;5;10;11;33
3965;18;7;9;10;9;35
3966;18;9;6;9;11;35
3967;18;7;15;6;10;38
3968;18;5;9;10;8;32
3969;18;5;8;17;12;42
3970;18;11;6;7;6;30
3971;18;11;6;10;11;38
3972;18;11;4;10;5;30
3973;18;12;11;10;9;42
3974;18;7;11;8;13;39
3975;18;5;8;7;13;33
3976;18;11;9;17;5;42
3977;18;10;12;13;9;44
3978;18;9;11;8;8;36
3979;18;14;12;9;9;44
3980;18;10;13;10;8;41
3981;18;11;10;8;17;46
3982;18;9;11;9;16;45
3983;18;8;7;9;12;36
3984;18;7;10;11;14;42
3985;18;12;13;8;11;44
3986;18;13;6;15;4;38
3987;18;12;6;7;7;32
3988;18;6;12;15;12;45
3989;18;11;5;6;14;36
3990;18;7;12;4;10;33
3991;18;9;9;5;11;34
3992;18;14;13;11;12;50
3993;18;5;8;8;11;32
3994;18;7;4;3;8;22
3995;18;6;4;5;8;23
3996;18;8;8;7;6;29
3997;18;5;12;5;12;34
3998;18;8;9;16;10;43
3999;18;3;11;4;12;30
4000;18;11;12;10;7;40
4001;18;7;11;13;9;40
4002;18;4;6;15;7;32
4003;18;6;5;6;8;25
4004;18;16;14;9;10;49
4005;18;7;5;9;11;32
4006;18;7;11;9;10;37
4007;20;203;213;221;210;847
4008;20;184;191;198;192;765
4009;20;139;173;180;187;679
4010;20;162;158;205;182;707
4011;20;141;188;158;123;610
4012;20;143;142;158;157;600
4013;20;140;159;137;134;570
4014;20;119;139;154;138;550
4015;20;123;150;142;131;546
4016;20;109;143;128;123;503
4017;20;116;136;133;105;490
4018;20;85;113;125;118;441
4019;20;90;144;106;100;440
4020;20;104;122;95;127;448
4021;20;96;114;103;96;409
4022;20;76;108;101;89;374
4023;20;82;99;89;98;368
4024;20;87;96;98;106;387
4025;20;79;85;93;87;344
4026;20;82;88;80;81;331
4027;20;80;102;73;100;355
4028;20;73;89;74;78;314
4029;20;59;67;71;74;271
4030;20;64;80;57;63;264
4031;20;62;54;77;72;265
4032;20;48;71;72;60;251
4033;20;48;54;66;74;242
4034;20;51;73;56;64;244
4035;20;49;73;64;55;241
4036;20;46;48;55;43;192
4037;20;50;50;51;51;202
4038;20;42;59;48;56;205
4039;20;40;62;64;51;217
4040;20;45;41;51;44;181
4041;20;37;31;40;45;153
4042;20;51;43;39;49;182
4043;20;37;40;41;51;169
4044;20;38;36;38;46;158
4045;20;38;36;34;36;144
4046;20;38;41;41;28;148
4047;20;32;34;37;28;131
4048;20;35;32;38;35;140
4049;20;23;36;33;39;131
4050;20;30;36;37;34;137
4051;20;20;31;30;26;107
4052;20;26;28;38;28;120
4053;20;18;34;35;20;107
4054;20;20;34;31;26;111
4055;20;29;30;25;31;115
4056;20;30;23;27;26;106
4057;20;19;21;27;33;100
4058;20;20;22;32;23;97
4059;20;21;31;27;24;103
4060;20;31;30;26;29;116
4061;20;16;23;26;17;82
4062;20;22;24;30;17;93
4063;20;22;27;24;15;88
4064;20;25;27;19;30;101
4065;20;15;21;26;17;79
4066;20;17;27;29;22;95
4067;20;16;23;18;14;71
4068;20;22;22;23;16;83
4069;20;18;22;20;26;86
4070;20;16;18;23;20;77
4071;20;11;15;24;19;69
4072;20;23;18;12;22;75
4073;20;15;20;19;17;71
4074;20;17;14;17;12;60
4075;20;16;19;19;19;73
4076;20;18;15;21;10;64
4077;20;13;16;17;11;57
4078;20;17;15;18;15;65
4079;20;19;19;13;16;67
4080;20;12;21;20;11;64
4081;20;13;18;18;15;64
4082;20;15;15;15;15;60
4083;20;12;14;15;18;59
4084;20;9;7;13;18;47
4085;20;13;15;13;13;54
4086;20;11;18;14;12;55
4087;20;18;14;12;15;59
4088;20;12;6;15;10;43
4089;20;5;13;13;12;43
4090;20;17;13;17;14;61
4091;20;7;13;13;11;44
4092;20;12;6;14;9;41
4093;20;13;17;21;15;66
4094;20;11;14;11;15;51
4095;20;12;11;13;19;55
4096;20;10;15;17;15;57
4097;20;6;16;15;16;53
4098;20;12;10;10;12;44
4099;20;6;6;13;5;30
4100;20;19;11;9;8;47
4101;20;10;15;17;14;56
4102;20;8;12;15;9;44
4103;20;7;11;8;8;34
4104;20;10;9;11;15;45
4105;20;10;15;18;13;56
4106;20;10;14;7;10;41
4107;20;8;12;20;7;47
4108;20;11;12;12;9;44
4109;20;6;11;11;9;37
4110;20;8;8;8;9;33
4111;20;7;11;11;14;43
4112;20;11;11;5;12;39
4113;20;6;9;11;6;32
4114;20;7;10;14;13;44
4115;20;11;12;10;11;44
4116;20;13;18;8;7;46
4117;20;13;15;19;15;62
4118;20;8;14;13;3;38
4119;20;9;10;17;12;48
4120;20;7;7;16;13;43
4121;20;8;10;8;14;40
4122;20;7;10;9;10;36
4123;20;3;8;8;9;28
4124;20;6;15;11;6;38
4125;20;9;13;12;14;48
4126;20;9;15;2;10;36
4127;20;4;17;7;15;43
4128;20;11;8;12;8;39
4129;20;6;11;10;16;43
4130;20;7;11;9;10;37
4131;20;8;12;10;9;39
4132;20;12;16;9;8;45
4133;20;6;8;5;11;30
4134;20;9;9;11;12;41
4135;20;6;10;13;14;43
4136;20;8;15;9;9;41
4137;20;11;8;10;8;37
4138;20;12;11;13;12;48
4139;20;9;6;11;10;36
4140;20;5;14;10;6;35
4141;20;8;12;10;13;43
4142;20;6;9;13;4;32
4143;20;9;12;5;10;36
4144;20;10;16;11;7;44
4145;20;8;10;13;12;43
4146;20;6;9;9;6;30
4147;20;9;12;10;8;39
4148;20;10;8;6;11;35
4149;20;6;14;10;11;41
4150;20;6;13;8;6;33
4151;20;12;4;6;12;34
4152;20;9;5;13;11;38
4153;20;5;16;9;6;36
4154;20;11;15;7;14;47
4155;20;12;10;13;8;43
4156;20;15;9;11;5;40
4157;20;5;11;12;12;40
4158;20;8;4;7;15;34
4159;20;7;10;9;15;41
4160;20;11;8;6;4;29
4161;20;15;9;6;12;42
4162;20;6;6;12;11;35
4163;20;6;12;5;7;30
4164;20;6;13;4;16;39
4165;20;7;5;10;8;30
4166;20;6;9;7;3;25
4167;20;10;6;8;11;35
4168;20;6;13;10;8;37
4169;20;10;13;11;6;40
4170;20;12;11;5;13;41
4171;20;8;6;17;7;38
4172;20;5;14;6;10;35
4173;20;11;16;8;4;39
4174;20;8;11;10;9;38
4175;20;6;12;3;10;31
4176;20;6;8;3;12;29
4177;20;10;12;7;11;40
4178;20;4;9;13;12;38
4179;20;10;13;5;10;38
4180;20;9;9;10;8;36
4181;20;12;7;8;11;38
4182;20;6;13;7;10;36
4183;20;9;10;7;10;36
4184;20;11;14;7;8;40
4185;20;4;11;10;9;34
4186;20;10;5;9;8;32
4187;20;5;13;11;14;43
4188;20;10;10;15;11;46
4189;20;4;3;13;6;26
4190;20;4;12;5;8;29
4191;20;7;5;12;15;39
4192;20;10;6;10;9;35
4193;20;7;9;12;13;41
4194;20;5;12;5;9;31
4195;20;12;8;11;11;42
4196;20;4;10;8;9;31
4197;20;6;18;9;7;40
4198;20;7;8;13;10;38
4199;20;5;12;7;9;33
4200;20;11;7;9;13;40
4201;20;4;4;11;4;23
4202;20;10;13;14;9;46
4203;20;8;4;12;13;37
4204;20;10;8;6;10;34
4205;20;8;9;10;11;38
4206;20;5;12;6;9;32
4207;20;7;12;13;9;41
4208;20;8;10;10;11;39
4209;20;15;11;9;9;44
4210;20;12;5;17;9;43
4211;20;10;11;11;8;40
4212;20;6;6;11;8;31
4213;20;4;8;12;6;30
4214;20;14;1;12;4;31
4215;20;7;8;8;12;35
4216;20;6;10;15;6;37
4217;20;13;9;12;10;44
4218;20;10;12;7;4;33
4219;20;9;11;10;6;36
4220;20;9;9;7;13;38
4221;20;9;7;3;10;29
4222;20;7;6;9;7;29
4223;20;7;11;8;7;33
4224;20;9;9;5;12;35
4225;20;13;5;12;1;31
4226;20;3;8;9;7;27
4227;20;11;10;8;10;39
4228;20;12;11;9;8;40
4229;20;12;6;8;6;32
4230;20;6;14;13;13;46
4231;20;7;11;10;15;43
4232;20;9;8;5;11;33
4233;20;9;13;6;10;38
4234;20;4;10;6;8;28
4235;20;7;13;6;12;38
4236;20;11;9;12;18;50
4237;20;12;10;12;13;47
4238;20;12;13;12;11;48
4239;20;7;12;7;4;30
4240;20;10;9;13;7;39
4241;20;3;7;8;7;25
4242;20;7;8;9;11;35
4243;20;15;12;10;8;45
4244;20;4;12;9;10;35
4245;20;5;10;7;9;31
4246;20;8;11;13;9;41
4247;20;8;7;12;7;34
4248;20;8;7;7;10;32
4249;20;7;8;12;6;33
4250;20;7;9;7;9;32
4251;20;3;6;11;6;26
4252;20;13;10;10;10;43
4253;20;8;5;10;11;34
4254;20;7;11;7;6;31
4255;20;5;5;9;12;31
4256;20;11;5;5;16;37
4257;20;10;5;8;13;36
4258;20;9;6;12;8;35
4259;20;10;9;10;11;40
4260;20;12;6;7;12;37
4261;20;13;15;8;6;42
4262;20;12;11;14;11;48
4263;20;12;9;7;12;40
4264;20;6;6;12;6;30
4265;20;54;58;50;50;212
4266;20;6;9;12;6;33
4267;20;8;14;11;8;41
4268;20;7;11;11;5;34
4269;20;15;8;13;9;45
4270;20;14;8;6;8;36
4271;20;8;7;12;6;33
4272;20;7;14;10;11;42
4273;20;13;12;12;8;45
4274;20;8;11;15;11;45
4275;20;6;11;11;9;37
4276;20;10;8;11;7;36
4277;20;6;9;10;7;32
4278;20;9;11;10;8;38
4279;20;4;8;10;12;34
4280;20;10;9;5;4;28
4281;20;9;2;10;8;29
4282;20;9;8;8;9;34
4283;20;9;9;4;13;35
4284;20;8;6;12;7;33
4285;20;11;5;14;15;45
4286;20;11;10;5;10;36
4287;20;11;14;6;7;38
4288;20;9;1;5;10;25
4289;20;10;7;5;2;24
4290;20;9;10;9;10;38
4291;20;11;8;14;9;42
4292;20;7;9;2;10;28
4293;20;8;11;7;9;35
4294;20;9;8;7;8;32
4295;20;6;6;10;11;33
4296;20;4;7;6;10;27
4297;20;7;9;2;13;31
4298;20;9;8;6;9;32
4299;20;8;10;10;13;41
4300;20;11;9;13;12;45
4301;20;11;8;14;9;42
4302;20;7;10;9;9;35
4303;20;6;7;6;8;27
4304;20;9;9;8;11;37
4305;20;8;6;13;10;37
4306;20;4;5;8;7;24
4307;20;7;6;10;12;35
4308;20;4;8;14;5;31
4309;20;4;14;12;10;40
4310;20;4;8;21;13;46
4311;20;11;10;7;9;37
4312;20;6;11;12;12;41
4313;20;4;2;10;9;25
4314;20;10;5;5;10;30
4315;20;6;10;9;14;39
4316;20;9;11;4;7;31
4317;20;7;13;10;12;42
4318;20;6;10;7;10;33
4319;20;10;9;11;3;33
4320;20;8;4;12;7;31
4321;20;8;16;7;12;43
4322;20;10;11;10;8;39
4323;20;8;5;8;9;30
4324;20;7;11;9;10;37
4325;20;12;12;9;16;49
4326;20;3;8;6;10;27
4327;20;5;9;11;9;34
4328;20;4;11;9;15;39
4329;20;10;6;2;8;26
4330;20;8;5;6;5;24
4331;20;9;8;4;3;24
4332;20;8;12;9;4;33
4333;20;9;11;9;5;34
4334;20;7;6;15;11;39
4335;20;5;11;6;9;31
4336;20;5;11;11;6;33
4337;20;12;12;16;5;45
4338;20;4;7;13;11;35
4339;20;4;7;10;8;29
4340;20;2;7;5;6;20
4341;20;12;12;14;7;45
4342;20;10;11;10;8;39
4343;20;5;6;16;7;34
4344;20;5;10;11;6;32
4345;20;6;4;12;9;31
4346;20;11;10;11;6;38
4347;20;7;7;11;7;32
4348;20;6;8;13;12;39
4349;20;11;9;10;10;40
4350;20;5;10;16;5;36
4351;20;7;8;11;8;34
4352;20;4;4;10;6;24
4353;20;6;13;9;10;38
4354;20;8;17;11;10;46
4355;20;8;9;10;10;37
4356;20;6;7;10;11;34
4357;20;6;4;10;8;28
4358;20;8;12;6;7;33
4359;20;9;13;4;11;37
4360;20;7;8;16;14;45
4361;20;9;11;14;11;45
4362;20;5;12;10;8;35
4363;20;6;12;10;6;34
4364;20;11;2;9;6;28
4365;20;5;10;11;10;36
4366;20;4;18;12;12;46
4367;20;8;5;10;11;34
4368;20;4;13;11;16;44
4369;20;7;14;3;12;36
4370;20;13;9;7;9;38
4371;20;9;13;13;11;46
4372;20;2;9;13;11;35
4373;20;11;8;10;9;38
4374;20;7;11;7;8;33
4375;20;11;7;11;8;37
4376;20;9;11;8;4;32
4377;20;12;5;10;6;33
4378;20;8;5;10;11;34
4379;20;12;10;6;14;42
4380;20;7;9;7;14;37
4381;20;7;7;12;11;37
4382;20;6;6;13;6;31
4383;20;4;7;5;3;19
4384;20;13;14;11;7;45
4385;20;10;9;11;6;36
4386;20;11;7;11;9;38
4387;20;6;10;5;7;28
4388;20;8;18;10;2;38
4389;20;8;7;11;9;35
4390;20;6;7;15;10;38
4391;20;7;11;13;6;37
4392;20;5;8;10;7;30
4393;20;5;8;4;7;24
4394;20;10;12;12;5;39
4395;20;8;8;10;8;34
4396;20;5;17;9;14;45
4397;20;6;5;7;9;27
4398;20;9;9;5;9;32
4399;20;5;14;11;4;34
4400;20;5;9;4;11;29
4401;20;5;9;7;16;37
4402;20;11;10;7;14;42
4403;20;10;7;6;5;28
4404;20;6;8;4;8;26
4405;20;3;7;8;7;25
4406;20;9;13;7;2;31
4407;20;9;5;10;6;30
4408;20;9;7;8;13;37
4409;20;3;10;11;9;33
4410;20;7;8;5;10;30
4411;20;6;8;8;8;30
4412;20;4;12;15;15;46
4413;22;264;288;278;252;1082
4414;22;210;262;250;226;948
4415;22;202;240;221;226;889
4416;22;212;242;206;214;874
4417;22;197;211;217;206;831
4418;22;174;210;201;217;802
4419;22;158;182;220;218;778
4420;22;191;191;176;174;732
4421;22;153;210;174;183;720
4422;22;139;169;156;188;652
4423;22;121;159;138;170;588
4424;22;143;152;168;163;626
4425;22;109;155;138;135;537
4426;22;121;169;151;120;561
4427;22;101;138;121;131;491
4428;22;121;118;126;132;497
4429;22;119;146;149;109;523
4430;22;89;136;117;125;467
4431;22;100;112;105;124;441
4432;22;86;116;110;102;414
4433;22;97;125;96;91;409
4434;22;65;100;94;95;354
4435;22;80;93;80;83;336
4436;22;70;81;86;87;324
4437;22;85;105;95;79;364
4438;22;73;83;95;81;332
4439;22;70;79;83;94;326
4440;22;74;87;77;78;316
4441;22;74;73;78;70;295
4442;22;61;63;75;66;265
4443;22;56;65;51;55;227
4444;22;47;57;58;72;234
4445;22;51;56;78;64;249
4446;22;55;58;64;52;229
4447;22;58;66;67;51;242
4448;22;39;55;67;48;209
4449;22;59;48;67;64;238
4450;22;31;50;56;42;179
4451;22;52;54;53;45;204
4452;22;37;44;49;43;173
4453;22;35;53;51;52;191
4454;22;42;45;40;51;178
4455;22;36;38;47;26;147
4456;22;33;41;49;34;157
4457;22;30;36;34;44;144
4458;22;23;37;36;36;132
4459;22;38;34;35;32;139
4460;22;29;41;44;32;146
4461;22;38;33;37;31;139
4462;22;32;21;36;30;119
4463;22;21;35;27;30;113
4464;22;30;23;31;26;110
4465;22;36;29;27;28;120
4466;22;25;32;38;28;123
4467;22;32;30;23;25;110
4468;22;27;27;30;22;106
4469;22;18;27;32;19;96
4470;22;18;28;20;22;88
4471;22;19;17;24;24;84
4472;22;22;27;25;21;95
4473;22;22;20;27;22;91
4474;22;18;23;19;20;80
4475;22;19;23;20;21;83
4476;22;10;22;31;18;81
4477;22;12;16;18;24;70
4478;22;19;15;25;13;72
4479;22;14;15;24;18;71
4480;22;15;17;20;14;66
4481;22;17;15;12;13;57
4482;22;11;14;21;14;60
4483;22;11;22;16;14;63
4484;22;16;18;16;14;64
4485;22;21;18;21;16;76
4486;22;13;11;19;12;55
4487;22;13;15;9;17;54
4488;22;13;12;14;19;58
4489;22;16;15;13;10;54
4490;22;19;16;11;11;57
4491;22;11;22;16;12;61
4492;22;13;15;15;18;61
4493;22;8;16;9;19;52
4494;22;12;13;16;11;52
4495;22;7;11;13;16;47
4496;22;14;11;17;13;55
4497;22;11;12;12;13;48
4498;22;12;14;14;18;58
4499;22;13;7;16;16;52
4500;22;15;18;10;14;57
4501;22;19;11;14;15;59
4502;22;13;8;16;16;53
4503;22;11;13;14;6;44
4504;22;13;10;15;9;47
4505;22;12;17;14;18;61
4506;22;14;8;5;12;39
4507;22;10;9;10;9;38
4508;22;8;14;17;14;53
4509;22;11;10;12;13;46
4510;22;12;9;10;13;44
4511;22;9;11;11;8;39
4512;22;6;9;15;15;45
4513;22;4;9;13;17;43
4514;22;9;10;15;11;45
4515;22;10;12;16;6;44
4516;22;16;12;8;11;47
4517;22;12;12;16;10;50
4518;22;2;10;11;7;30
4519;22;7;6;9;11;33
4520;22;10;8;14;14;46
4521;22;8;8;8;11;35
4522;22;6;12;19;16;53
4523;22;9;10;9;16;44
4524;22;12;11;8;7;38
4525;22;11;8;12;6;37
4526;22;9;8;14;11;42
4527;22;11;16;4;12;43
4528;22;10;11;11;19;51
4529;22;10;17;10;6;43
4530;22;12;8;11;7;38
4531;22;10;6;4;7;27
4532;22;8;9;8;8;33
4533;22;4;14;11;5;34
4534;22;11;7;8;7;33
4535;22;5;7;10;18;40
4536;22;7;8;9;7;31
4537;22;8;9;13;13;43
4538;22;5;6;13;7;31
4539;22;8;14;10;12;44
4540;22;6;12;14;13;45
4541;22;10;10;15;8;43
4542;22;8;11;9;6;34
4543;22;6;10;6;6;28
4544;22;10;15;7;9;41
4545;22;7;8;12;9;36
4546;22;5;10;6;10;31
4547;22;6;12;8;6;32
4548;22;15;3;9;11;38
4549;22;17;5;9;11;42
4550;22;7;8;11;12;38
4551;22;7;8;10;9;34
4552;22;11;13;15;10;49
4553;22;6;6;10;9;31
4554;22;12;18;11;15;56
4555;22;10;9;5;7;31
4556;22;10;7;17;6;40
4557;22;11;11;7;8;37
4558;22;6;12;13;9;40
4559;22;6;13;13;11;43
4560;22;10;12;6;11;39
4561;22;2;8;11;11;32
4562;22;16;6;9;9;40
4563;22;9;8;12;10;39
4564;22;10;11;7;7;35
4565;22;7;10;10;10;37
4566;22;6;12;7;10;35
4567;22;7;13;8;10;38
4568;22;8;13;5;6;32
4569;22;8;8;10;11;37
4570;22;7;10;8;5;30
4571;22;10;10;9;8;37
4572;22;7;10;4;4;25
4573;22;5;9;7;7;28
4574;22;9;9;10;12;40
4575;22;5;3;6;14;28
4576;22;11;5;12;7;35
4577;22;12;16;10;8;46
4578;22;6;7;14;12;39
4579;22;5;14;9;10;38
4580;22;7;10;13;8;38
4581;22;8;8;10;5;31
4582;22;13;7;9;4;33
4583;22;8;9;5;7;29
4584;22;4;6;9;7;26
4585;22;3;5;7;10;25
4586;22;13;10;9;10;42
4587;22;4;13;11;11;39
4588;22;8;11;9;4;32
4589;22;3;7;13;10;33
4590;22;5;14;15;6;40
4591;22;7;12;11;4;34
4592;22;9;5;9;6;29
4593;22;9;7;10;13;39
4594;22;4;14;14;8;40
4595;22;10;14;5;8;37
4596;22;8;9;12;5;34
4597;22;6;14;2;9;31
4598;22;5;10;10;5;30
4599;22;11;7;12;9;39
4600;22;7;10;12;9;38
4601;22;8;10;6;7;31
4602;22;5;8;9;6;28
4603;22;6;8;8;12;34
4604;22;6;9;14;12;41
4605;22;12;8;6;9;35
4606;22;13;7;8;8;36
4607;22;7;21;6;6;40
4608;22;7;9;8;9;33
4609;22;11;6;14;8;39
4610;22;9;13;14;8;44
4611;22;8;14;8;12;42
4612;22;10;11;7;10;38
4613;22;3;14;7;11;35
4614;22;8;13;11;5;37
4615;22;11;12;10;6;39
4616;22;11;8;8;13;40
4617;22;9;9;8;8;34
4618;22;9;6;7;9;31
4619;22;5;8;6;7;26
4620;22;4;4;8;8;24
4621;22;8;8;7;10;33
4622;22;10;10;13;11;44
4623;22;10;9;9;13;41
4624;22;8;9;7;11;35
4625;22;5;12;9;9;35
4626;22;13;10;10;11;44
4627;22;9;6;11;6;32
4628;22;7;4;9;9;29
4629;22;8;5;10;8;31
4630;22;8;12;9;10;39
4631;22;10;11;9;9;39
4632;22;11;10;19;18;58
4633;22;10;20;9;8;47
4634;22;5;14;9;11;39
4635;22;15;8;10;15;48
4636;22;8;12;7;12;39
4637;22;7;10;8;11;36
4638;22;9;7;6;11;33
4639;22;6;12;7;13;38
4640;22;6;16;14;6;42
4641;22;13;13;12;7;45
4642;22;11;8;7;10;36
4643;22;6;10;12;7;35
4644;22;7;12;13;7;39
4645;22;11;14;5;14;44
4646;22;7;12;8;8;35
4647;22;6;3;13;5;27
4648;22;9;8;12;8;37
4649;22;6;7;9;6;28
4650;22;5;8;6;9;28
4651;22;4;14;7;6;31
4652;22;10;12;7;9;38
4653;22;12;12;16;11;51
4654;22;6;3;11;12;32
4655;22;10;11;14;13;48
4656;22;4;11;13;10;38
4657;22;12;6;7;9;34
4658;22;6;15;16;3;40
4659;22;4;12;11;9;36
4660;22;6;9;8;12;35
4661;22;8;8;7;15;38
4662;22;11;18;5;4;38
4663;22;9;8;10;12;39
4664;22;10;10;8;10;38
4665;22;7;8;5;15;35
4666;22;8;12;10;4;34
4667;22;13;11;8;5;37
4668;22;8;10;7;10;35
4669;22;13;6;9;6;34
4670;22;9;10;7;7;33
4671;22;5;6;13;7;31
4672;22;14;11;11;4;40
4673;22;8;11;8;6;33
4674;22;10;8;13;11;42
4675;22;7;6;8;14;35
4676;22;5;11;7;14;37
4677;22;13;13;8;5;39
4678;22;8;10;13;7;38
4679;22;4;13;11;15;43
4680;22;9;7;5;6;27
4681;22;8;14;11;7;40
4682;22;11;14;7;8;40
4683;22;13;15;12;6;46
4684;22;7;10;9;6;32
4685;22;9;10;8;17;44
4686;22;18;12;5;13;48
4687;22;12;6;8;3;29
4688;22;8;11;6;14;39
4689;22;9;5;12;6;32
4690;22;5;12;11;12;40
4691;22;10;6;9;9;34
4692;22;10;12;9;10;41
4693;22;8;4;6;12;30
4694;22;8;10;6;13;37
4695;22;9;5;7;11;32
4696;22;9;15;7;11;42
4697;22;10;5;13;3;31
4698;22;9;4;9;14;36
4699;22;11;11;5;11;38
4700;22;7;9;8;10;34
4701;22;8;7;8;5;28
4702;22;4;10;12;13;39
4703;22;7;13;7;4;31
4704;22;4;9;7;10;30
4705;22;8;10;10;8;36
4706;22;6;11;7;13;37
4707;22;9;9;12;10;40
4708;22;10;10;7;5;32
4709;22;5;13;6;8;32
4710;22;8;6;12;11;37
4711;22;7;11;9;9;36
4712;22;7;10;9;6;32
4713;22;9;15;4;11;39
4714;22;12;8;10;6;36
4715;22;3;8;5;6;22
4716;22;6;7;13;11;37
4717;22;4;13;8;6;31
4718;22;7;9;7;9;32
4719;22;5;14;9;9;37
4720;22;12;8;9;13;42
4721;22;7;9;5;8;29
4722;22;13;5;16;10;44
4723;22;6;8;7;10;31
4724;22;9;5;9;7;30
4725;22;11;6;11;5;33
4726;22;11;16;3;16;46
4727;22;11;14;8;5;38
4728;22;4;11;8;9;32
4729;22;9;13;12;3;37
4730;22;6;8;15;6;35
4731;22;7;8;16;4;35
4732;22;11;14;8;5;38
4733;22;9;14;12;7;42
4734;22;11;8;10;5;34
4735;22;6;11;7;11;35
4736;22;3;13;11;7;34
4737;22;7;11;17;9;44
4738;22;10;6;8;7;31
4739;22;7;6;10;11;34
4740;22;12;6;10;8;36
4741;22;10;9;6;13;38
4742;22;6;16;10;14;46
4743;22;10;5;14;11;40
4744;22;5;11;7;7;30
4745;22;3;4;6;12;25
4746;22;7;8;4;6;25
4747;22;7;10;9;8;34
4748;22;10;13;7;8;38
4749;22;6;10;9;6;31
4750;22;10;12;9;7;38
4751;22;4;2;9;11;26
4752;22;5;6;10;8;29
4753;22;7;10;6;6;29
4754;22;6;16;10;12;44
4755;22;7;7;12;8;34
4756;22;7;7;9;8;31
4757;22;4;6;6;6;22
4758;22;7;4;6;4;21
4759;22;9;9;5;11;34
4760;22;4;8;7;5;24
4761;22;8;8;5;12;33
4762;22;4;10;11;9;34
4763;22;10;11;13;6;40
4764;22;9;14;6;7;36
4765;22;10;8;5;9;32
4766;22;10;8;12;3;33
4767;22;13;6;7;3;29
4768;22;8;11;11;8;38
4769;22;7;9;7;8;31
4770;22;5;8;10;13;36
4771;22;3;10;5;16;34
4772;22;4;15;11;10;40
4773;22;8;10;8;17;43
4774;22;7;9;9;5;30
4775;22;6;12;11;4;33
4776;22;7;6;5;8;26
4777;22;4;5;11;5;25
4778;22;11;8;10;8;37
4779;22;7;11;12;8;38
4780;22;8;9;14;4;35
4781;22;12;10;14;4;40
4782;22;10;6;9;6;31
4783;22;8;14;14;6;42
4784;22;6;12;8;9;35
4785;22;7;8;9;4;28
4786;22;5;8;4;6;23
4787;22;6;11;8;6;31
4788;22;7;11;10;7;35
4789;22;6;10;13;6;35
4790;22;7;9;13;10;39
4791;22;7;12;3;11;33
4792;22;10;11;8;7;36
4793;22;8;8;7;6;29
4794;22;9;10;9;8;36
4795;22;9;8;11;7;35
4796;22;9;12;10;10;41
4797;22;8;7;7;3;25
4798;22;7;8;9;8;32
4799;22;8;8;7;8;31
4800;22;6;5;11;3;25
4801;22;6;4;10;9;29
4802;22;12;8;11;7;38
4803;22;10;11;6;8;35
4804;22;8;7;10;5;30
4805;22;3;8;4;10;25
4806;22;7;5;3;12;27
4807;22;1;10;16;6;33
4808;22;11;10;10;10;41
4809;22;12;8;9;5;34
4810;22;13;8;9;7;37
4811;22;12;6;6;4;28
4812;24;201;207;192;199;799
4813;24;162;199;160;147;668
4814;24;156;181;182;171;690
4815;24;128;164;166;141;599
4816;24;128;182;155;154;619
4817;24;128;140;149;150;567
4818;24;115;146;133;146;540
4819;24;90;135;112;128;465
4820;24;120;147;128;134;529
4821;24;119;121;109;137;486
4822;24;83;119;110;100;412
4823;24;110;110;109;97;426
4824;24;90;101;106;95;392
4825;24;98;101;92;94;385
4826;24;80;87;104;101;372
4827;24;92;99;89;110;390
4828;24;80;85;99;81;345
4829;24;61;106;80;80;327
4830;24;62;82;92;67;303
4831;24;75;79;88;76;318
4832;24;65;64;74;70;273
4833;24;62;63;63;54;242
4834;24;49;69;64;76;258
4835;24;60;68;49;55;232
4836;24;49;69;67;64;249
4837;24;54;63;71;46;234
4838;24;40;65;55;49;209
4839;24;40;59;51;42;192
4840;24;46;67;53;52;218
4841;24;43;54;53;48;198
4842;24;49;44;50;44;187
4843;24;39;45;59;45;188
4844;24;34;46;52;61;193
4845;24;49;44;43;55;191
4846;24;36;40;45;38;159
4847;24;38;40;42;43;163
4848;24;31;37;39;30;137
4849;24;26;48;41;40;155
4850;24;30;43;45;34;152
4851;24;28;35;40;37;140
4852;24;34;30;30;22;116
4853;24;31;42;30;27;130
4854;24;29;26;25;33;113
4855;24;24;24;43;27;118
4856;24;20;33;42;21;116
4857;24;23;42;26;24;115
4858;24;39;30;34;29;132
4859;24;24;30;33;21;108
4860;24;31;24;28;25;108
4861;24;25;29;26;35;115
4862;24;15;20;21;26;82
4863;24;17;20;23;26;86
4864;24;18;24;20;21;83
4865;24;10;23;21;29;83
4866;24;18;25;24;18;85
4867;24;15;23;18;24;80
4868;24;21;25;27;17;90
4869;24;18;22;20;29;89
4870;24;16;24;16;20;76
4871;24;8;16;17;23;64
4872;24;14;19;20;18;71
4873;24;16;10;27;14;67
4874;24;13;18;9;17;57
4875;24;8;19;17;22;66
4876;24;14;11;17;19;61
4877;24;10;14;18;23;65
4878;24;16;16;16;22;70
4879;24;25;17;17;12;71
4880;24;11;15;11;22;59
4881;24;11;17;13;11;52
4882;24;15;9;13;23;60
4883;24;9;14;28;9;60
4884;24;13;21;15;15;64
4885;24;23;21;16;12;72
4886;24;18;20;18;20;76
4887;24;15;14;10;10;49
4888;24;8;16;20;18;62
4889;24;5;12;12;16;45
4890;24;9;16;13;10;48
4891;24;8;17;18;16;59
4892;24;11;11;10;12;44
4893;24;11;14;16;13;54
4894;24;11;17;14;12;54
4895;24;6;12;16;10;44
4896;24;10;14;4;11;39
4897;24;14;11;12;12;49
4898;24;10;14;12;10;46
4899;24;8;15;12;16;51
4900;24;10;14;12;13;49
4901;24;12;9;10;18;49
4902;24;7;7;8;13;35
4903;24;10;10;17;18;55
4904;24;9;10;10;10;39
4905;24;5;14;13;5;37
4906;24;8;13;10;11;42
4907;24;9;13;8;21;51
4908;24;9;15;13;13;50
4909;24;11;16;14;12;53
4910;24;6;5;12;9;32
4911;24;10;9;13;9;41
4912;24;7;8;10;8;33
4913;24;11;9;10;10;40
4914;24;12;9;12;12;45
4915;24;8;6;11;7;32
4916;24;12;12;17;15;56
4917;24;16;8;10;10;44
4918;24;7;16;7;7;37
4919;24;5;7;9;5;26
4920;24;14;12;13;10;49
4921;24;7;11;5;10;33
4922;24;6;12;8;11;37
4923;24;3;6;8;12;29
4924;24;11;9;12;11;43
4925;24;9;16;6;15;46
4926;24;7;2;13;7;29
4927;24;12;12;16;12;52
4928;24;11;11;9;9;40
4929;24;7;14;6;8;35
4930;24;6;12;12;8;38
4931;24;10;10;12;5;37
4932;24;10;7;9;14;40
4933;24;5;11;11;9;36
4934;24;7;5;5;8;25
4935;24;8;9;6;5;28
4936;24;8;7;8;9;32
4937;24;9;7;10;8;34
4938;24;7;13;7;4;31
4939;24;9;13;15;10;47
4940;24;6;12;8;10;36
4941;24;7;4;13;5;29
4942;24;5;12;8;14;39
4943;24;4;9;10;9;32
4944;24;13;12;9;10;44
4945;24;5;12;11;6;34
4946;24;9;8;7;5;29
4947;24;4;7;12;8;31
4948;24;9;9;11;9;38
4949;24;5;8;12;11;36
4950;24;8;12;11;14;45
4951;24;12;10;4;11;37
4952;24;10;5;11;9;35
4953;24;7;15;12;16;50
4954;24;4;14;11;12;41
4955;24;10;7;5;3;25
4956;24;3;8;9;4;24
4957;24;10;13;6;6;35
4958;24;6;10;9;7;32
4959;24;4;13;5;11;33
4960;24;9;8;10;8;35
4961;24;9;6;15;11;41
4962;24;12;12;9;6;39
4963;24;12;5;10;11;38
4964;24;7;13;16;3;39
4965;24;11;8;7;12;38
4966;24;7;11;10;6;34
4967;24;12;5;9;10;36
4968;24;5;7;12;9;33
4969;24;7;15;9;7;38
4970;24;4;2;2;8;16
4971;24;10;11;6;7;34
4972;24;5;5;12;10;32
4973;24;7;5;8;10;30
4974;24;8;11;12;8;39
4975;24;5;6;7;8;26
4976;24;4;8;6;7;25
4977;24;10;10;8;9;37
4978;24;5;15;9;9;38
4979;24;9;18;13;3;43
4980;24;7;10;13;7;37
4981;24;7;9;10;7;33
4982;24;9;8;18;3;38
4983;24;7;6;11;7;31
4984;24;9;13;11;8;41
4985;24;5;6;13;9;33
4986;24;9;6;8;10;33
4987;24;8;12;8;7;35
4988;24;12;8;12;11;43
4989;24;11;9;10;15;45
4990;24;11;10;10;7;38
4991;24;6;7;4;11;28
4992;24;5;7;5;7;24
4993;24;7;4;10;7;28
4994;24;10;7;9;5;31
4995;24;7;10;6;11;34
4996;24;8;8;11;10;37
4997;24;9;6;9;10;34
4998;24;8;11;10;6;35
4999;24;9;6;14;7;36
5000;24;7;16;14;12;49
5001;24;7;11;11;7;36
5002;24;3;14;12;14;43
5003;24;10;12;8;8;38
5004;24;11;8;6;8;33
5005;24;7;12;9;11;39
5006;24;3;6;7;11;27
5007;24;6;8;12;9;35
5008;24;3;6;9;6;24
5009;24;8;8;3;9;28
5010;24;12;21;14;6;53
5011;24;14;14;11;6;45
5012;24;4;12;14;9;39
5013;24;12;10;11;6;39
5014;24;7;15;10;9;41
5015;24;8;7;8;10;33
5016;24;7;5;9;11;32
5017;24;8;10;11;7;36
5018;24;4;14;7;13;38
5019;24;5;12;8;8;33
5020;24;7;15;4;4;30
5021;24;11;10;6;6;33
5022;24;12;8;11;6;37
5023;24;8;6;12;12;38
5024;24;12;5;9;11;37
5025;24;5;4;9;12;30
5026;24;15;12;7;9;43
5027;24;9;2;14;5;30
5028;24;11;8;6;9;34
5029;24;9;12;12;10;43
5030;24;7;8;6;18;39
5031;24;5;4;7;6;22
5032;24;5;5;10;7;27
5033;24;4;10;6;15;35
5034;24;9;13;7;9;38
5035;24;8;8;5;7;28
5036;24;10;4;6;13;33
5037;24;5;11;11;5;32
5038;24;11;8;12;9;40
5039;24;4;6;8;13;31
5040;24;8;15;6;7;36
5041;24;4;10;6;12;32
5042;24;12;14;12;7;45
5043;24;16;9;9;5;39
5044;24;10;11;5;10;36
5045;24;6;7;11;5;29
5046;24;6;6;4;17;33
5047;24;12;9;9;9;39
5048;24;11;11;6;7;35
5049;24;4;9;5;7;25
5050;24;4;9;5;4;22
5051;24;5;8;10;8;31
5052;24;12;6;8;6;32
5053;24;4;12;11;7;34
5054;24;10;11;10;9;40
5055;24;9;12;7;9;37
5056;24;6;11;12;6;35
5057;24;4;12;6;2;24
5058;24;7;9;12;13;41
5059;24;8;11;9;8;36
5060;24;8;8;13;12;41
5061;24;7;10;8;7;32
5062;24;10;7;8;9;34
5063;24;3;7;6;7;23
5064;24;7;6;5;9;27
5065;24;6;10;8;6;30
5066;24;8;9;5;11;33
5067;24;2;7;16;9;34
5068;24;9;6;9;8;32
5069;24;6;11;11;8;36
5070;24;9;10;9;6;34
5071;24;11;8;9;10;38
5072;24;9;8;4;15;36
5073;24;4;6;8;6;24
5074;24;9;12;8;6;35
5075;24;11;17;8;6;42
5076;24;14;15;12;11;52
5077;24;8;13;12;5;38
5078;24;11;9;6;8;34
5079;24;5;12;12;9;38
5080;24;8;12;12;7;39
5081;24;6;6;9;5;26
5082;24;4;10;9;9;32
5083;24;4;8;9;12;33
5084;24;7;5;9;9;30
5085;24;6;9;2;8;25
5086;24;7;8;9;12;36
5087;24;12;5;12;7;36
5088;24;8;9;12;7;36
5089;24;10;6;7;7;30
5090;24;16;13;10;3;42
5091;24;11;11;9;8;39
5092;24;9;9;10;7;35
5093;24;5;11;8;12;36
5094;24;7;11;10;12;40
5095;24;10;7;13;10;40
5096;24;7;14;15;9;45
5097;24;5;12;12;7;36
5098;24;7;15;5;12;39
5099;24;9;8;6;13;36
5100;24;6;8;8;10;32
5101;24;5;9;13;9;36
5102;24;7;9;7;9;32
5103;24;4;7;9;13;33
5104;24;6;15;9;7;37
5105;24;14;8;13;10;45
5106;24;6;4;15;7;32
5107;24;5;14;8;8;35
5108;24;11;16;12;7;46
5109;24;8;13;6;7;34
5110;24;8;9;11;13;41
5111;24;7;8;5;3;23
5112;24;5;10;14;4;33
5113;24;12;7;4;4;27
5114;24;3;8;5;8;24
5115;24;2;16;10;16;44
5116;24;8;5;9;9;31
5117;24;4;10;8;7;29
5118;24;9;8;8;8;33
5119;24;8;6;9;9;32
5120;24;4;11;8;14;37
5121;24;7;9;11;9;36
5122;24;11;8;6;11;36
5123;24;6;10;11;9;36
5124;24;4;6;17;6;33
5125;24;11;8;16;16;51
5126;24;3;9;6;9;27
5127;24;10;13;6;19;48
5128;24;13;8;8;12;41
5129;24;10;3;15;8;36
5130;24;4;7;7;9;27
5131;24;6;12;6;6;30
5132;24;8;10;11;4;33
5133;24;9;9;10;16;44
5134;24;9;8;10;7;34
5135;24;10;7;8;9;34
5136;24;11;7;10;3;31
5137;24;8;13;8;4;33
5138;24;9;6;7;8;30
5139;24;8;5;7;8;28
5140;24;7;9;10;8;34
5141;24;3;4;9;6;22
5142;24;8;10;6;14;38
5143;24;3;18;10;9;40
5144;24;6;12;10;8;36
5145;24;5;16;11;7;39
5146;24;9;6;8;12;35
5147;24;10;10;10;9;39
5148;24;9;9;6;7;31
5149;24;6;11;8;5;30
5150;24;9;13;7;8;37
5151;24;5;7;12;6;30
5152;24;11;9;10;7;37
5153;24;6;9;10;12;37
5154;24;5;7;9;4;25
5155;24;6;12;10;7;35
5156;24;4;8;14;10;36
5157;24;5;10;5;6;26
5158;24;3;9;11;6;29
5159;24;8;8;4;11;31
5160;24;7;8;10;5;30
5161;24;9;5;6;6;26
5162;24;5;9;9;8;31
5163;24;9;12;10;5;36
5164;24;7;5;8;12;32
5165;24;4;6;13;6;29
5166;24;6;8;10;9;33
5167;24;10;5;12;10;37
5168;24;4;11;10;9;34
5169;24;9;15;8;7;39
5170;24;10;7;9;11;37
5171;24;5;12;6;8;31
5172;24;3;13;11;13;40
5173;24;5;10;13;6;34
5174;24;11;4;12;6;33
5175;24;10;11;5;11;37
5176;24;6;11;9;11;37
5177;24;12;10;10;7;39
5178;24;9;9;11;8;37
5179;24;4;12;12;7;35
5180;24;14;11;6;6;37
5181;24;5;10;6;11;32
5182;24;3;13;6;8;30
5183;24;7;16;6;12;41
5184;24;7;8;5;9;29
5185;24;5;11;9;12;37
5186;24;7;12;8;9;36
5187;24;10;9;5;9;33
5188;24;5;4;8;9;26
5189;24;8;13;6;16;43
5190;24;2;12;9;5;28
5191;24;7;10;10;4;31
5192;24;6;4;13;11;34
5193;24;6;14;9;7;36
5194;24;10;8;5;2;25
5195;24;9;8;9;3;29
5196;24;6;7;6;10;29
5197;24;8;6;8;7;29
5198;24;7;8;10;8;33
5199;24;1;10;8;3;22
5200;24;8;4;11;5;28
5201;24;4;12;8;14;38
5202;24;6;8;7;6;27
5203;24;6;9;6;7;28
5204;24;4;5;6;3;18
5205;24;7;5;5;11;28
5206;24;11;8;7;10;36
5207;24;7;11;7;9;34
5208;24;6;15;6;9;36
5209;24;11;9;4;2;26
5210;24;10;12;7;9;38
5211;24;9;11;7;9;36
5212;24;10;10;11;5;36
5213;26;319;371;315;342;1347
5214;26;265;297;301;307;1170
5215;26;250;289;285;305;1129
5216;26;234;282;258;252;1026
5217;26;235;271;245;262;1013
5218;26;215;277;269;261;1022
5219;26;205;222;228;214;869
5220;26;211;233;182;211;837
5221;26;175;199;208;206;788
5222;26;192;209;216;208;825
5223;26;171;221;200;214;806
5224;26;189;185;199;192;765
5225;26;141;191;189;189;710
5226;26;155;181;167;153;656
5227;26;137;180;184;164;665
5228;26;145;159;154;134;592
5229;26;155;158;170;134;617
5230;26;131;138;131;137;537
5231;26;152;153;141;151;597
5232;26;127;150;137;121;535
5233;26;100;113;141;147;501
5234;26;100;105;131;133;469
5235;26;103;128;125;115;471
5236;26;96;115;106;92;409
5237;26;93;121;99;101;414
5238;26;99;124;104;114;441
5239;26;91;91;99;96;377
5240;26;70;86;98;86;340
5241;26;78;82;97;90;347
5242;26;70;91;96;86;343
5243;26;66;74;97;80;317
5244;26;68;82;84;76;310
5245;26;84;85;79;77;325
5246;26;66;75;86;74;301
5247;26;62;76;62;63;263
5248;26;59;76;71;57;263
5249;26;60;55;54;53;222
5250;26;49;57;71;69;246
5251;26;48;62;71;52;233
5252;26;46;62;59;52;219
5253;26;49;53;61;58;221
5254;26;52;58;46;46;202
5255;26;37;52;59;47;195
5256;26;29;45;49;56;179
5257;26;33;61;64;35;193
5258;26;46;44;38;56;184
5259;26;39;27;38;50;154
5260;26;46;46;42;23;157
5261;26;38;40;41;32;151
5262;26;41;46;39;45;171
5263;26;38;47;39;42;166
5264;26;45;32;32;36;145
5265;26;40;25;42;40;147
5266;26;35;43;38;37;153
5267;26;32;32;40;32;136
5268;26;30;30;26;31;117
5269;26;28;38;30;26;122
5270;26;21;27;30;26;104
5271;26;25;30;34;34;123
5272;26;17;24;23;28;92
5273;26;28;20;26;24;98
5274;26;23;24;30;30;107
5275;26;27;29;22;19;97
5276;26;28;28;26;28;110
5277;26;17;22;31;24;94
5278;26;24;34;22;18;98
5279;26;30;24;24;21;99
5280;26;26;30;17;27;100
5281;26;10;16;22;19;67
5282;26;13;24;24;24;85
5283;26;16;23;19;14;72
5284;26;16;15;16;23;70
5285;26;27;26;19;19;91
5286;26;15;21;15;23;74
5287;26;15;24;15;14;68
5288;26;18;18;16;17;69
5289;26;18;20;18;18;74
5290;26;16;13;13;22;64
5291;26;10;24;8;14;56
5292;26;15;16;16;19;66
5293;26;11;20;19;20;70
5294;26;14;14;16;12;56
5295;26;13;15;15;14;57
5296;26;12;21;23;11;67
5297;26;10;13;12;15;50
5298;26;16;16;17;16;65
5299;26;8;19;15;10;52
5300;26;18;15;16;13;62
5301;26;17;9;12;10;48
5302;26;11;15;19;17;62
5303;26;9;21;10;7;47
5304;26;9;10;16;7;42
5305;26;7;15;14;10;46
5306;26;15;14;14;9;52
5307;26;15;15;14;17;61
5308;26;4;9;14;11;38
5309;26;10;10;12;9;41
5310;26;6;10;9;12;37
5311;26;12;7;10;5;34
5312;26;6;10;14;10;40
5313;26;6;12;11;14;43
5314;26;8;14;13;12;47
5315;26;8;6;15;5;34
5316;26;8;8;11;6;33
5317;26;7;9;20;12;48
5318;26;14;6;11;4;35
5319;26;11;12;7;8;38
5320;26;6;11;8;6;31
5321;26;13;14;13;13;53
5322;26;7;7;14;10;38
5323;26;10;9;14;11;44
5324;26;8;11;16;5;40
5325;26;6;8;10;6;30
5326;26;10;8;14;6;38
5327;26;8;12;11;13;44
5328;26;8;14;12;11;45
5329;26;14;7;13;9;43
5330;26;8;16;7;8;39
5331;26;9;8;6;13;36
5332;26;15;11;13;10;49
5333;26;11;11;11;5;38
5334;26;11;13;8;11;43
5335;26;9;15;9;5;38
5336;26;11;8;9;13;41
5337;26;10;6;12;14;42
5338;26;8;15;11;12;46
5339;26;11;19;6;7;43
5340;26;8;10;9;9;36
5341;26;3;10;11;9;33
5342;26;12;13;11;7;43
5343;26;4;13;8;15;40
5344;26;8;11;6;10;35
5345;26;9;13;10;14;46
5346;26;10;7;8;8;33
5347;26;11;16;7;9;43
5348;26;8;8;6;8;30
5349;26;12;8;10;9;39
5350;26;6;12;11;5;34
5351;26;5;17;12;11;45
5352;26;6;13;13;5;37
5353;26;7;4;12;6;29
5354;26;7;10;10;10;37
5355;26;16;13;10;7;46
5356;26;8;8;7;11;34
5357;26;6;11;8;10;35
5358;26;9;9;9;11;38
5359;26;9;11;7;14;41
5360;26;5;5;15;15;40
5361;26;10;7;11;10;38
5362;26;4;9;9;8;30
5363;26;9;16;11;7;43
5364;26;7;11;10;2;30
5365;26;6;4;6;2;18
5366;26;10;13;9;6;38
5367;26;10;13;13;14;50
5368;26;10;8;14;13;45
5369;26;8;6;8;9;31
5370;26;6;7;10;6;29
5371;26;5;9;8;8;30
5372;26;7;16;11;11;45
5373;26;8;7;7;4;26
5374;26;7;7;7;11;32
5375;26;9;12;12;10;43
5376;26;6;14;2;10;32
5377;26;8;7;10;13;38
5378;26;8;13;5;11;37
5379;26;6;7;12;10;35
5380;26;7;6;8;8;29
5381;26;11;14;12;5;42
5382;26;6;14;9;12;41
5383;26;4;10;9;8;31
5384;26;13;12;7;11;43
5385;26;11;11;9;4;35
5386;26;10;10;9;11;40
5387;26;8;8;10;5;31
5388;26;9;10;8;8;35
5389;26;12;13;6;14;45
5390;26;9;8;14;4;35
5391;26;12;11;7;11;41
5392;26;8;4;9;9;30
5393;26;8;6;9;8;31
5394;26;5;10;15;5;35
5395;26;11;12;5;7;35
5396;26;9;9;7;8;33
5397;26;6;12;10;11;39
5398;26;9;11;11;5;36
5399;26;7;8;10;5;30
5400;26;5;6;6;8;25
5401;26;5;12;10;0;27
5402;26;4;3;12;6;25
5403;26;6;9;9;11;35
5404;26;14;12;9;5;40
5405;26;9;12;9;7;37
5406;26;7;10;9;9;35
5407;26;6;14;10;10;40
5408;26;8;14;6;9;37
5409;26;9;14;9;3;35
5410;26;8;8;13;8;37
5411;26;5;7;8;8;28
5412;26;7;12;5;9;33
5413;26;9;6;10;7;32
5414;26;9;8;7;6;30
5415;26;4;8;9;12;33
5416;26;11;16;9;15;51
5417;26;12;7;6;12;37
5418;26;7;12;8;5;32
5419;26;8;9;12;12;41
5420;26;4;9;9;6;28
5421;26;4;8;10;6;28
5422;26;8;7;13;8;36
5423;26;6;12;9;9;36
5424;26;5;13;10;7;35
5425;26;8;9;17;10;44
5426;26;4;10;9;5;28
5427;26;4;8;7;4;23
5428;26;8;15;9;11;43
5429;26;6;11;7;5;29
5430;26;9;12;12;11;44
5431;26;2;11;9;6;28
5432;26;8;5;13;6;32
5433;26;6;8;10;12;36
5434;26;7;5;7;5;24
5435;26;7;10;5;5;27
5436;26;8;1;16;7;32
5437;26;5;11;12;7;35
5438;26;10;17;5;16;48
5439;26;7;5;9;9;30
5440;26;8;13;12;9;42
5441;26;7;10;12;6;35
5442;26;8;9;9;11;37
5443;26;2;4;11;14;31
5444;26;8;5;4;4;21
5445;26;8;10;11;3;32
5446;26;9;8;15;9;41
5447;26;6;1;6;4;17
5448;26;6;9;5;11;31
5449;26;9;15;13;9;46
5450;26;10;10;7;13;40
5451;26;6;9;9;10;34
5452;26;5;12;8;10;35
5453;26;6;2;14;10;32
5454;26;6;8;7;11;32
5455;26;5;5;6;7;23
5456;26;8;15;9;13;45
5457;26;5;3;11;9;28
5458;26;10;7;11;8;36
5459;26;3;13;9;10;35
5460;26;2;8;12;9;31
5461;26;9;8;9;4;30
5462;26;8;7;6;5;26
5463;26;11;3;11;4;29
5464;26;10;7;8;8;33
5465;26;7;12;12;8;39
5466;26;9;7;12;15;43
5467;26;7;7;11;12;37
5468;26;3;7;10;8;28
5469;26;9;8;11;10;38
5470;26;7;7;8;9;31
5471;26;4;9;7;9;29
5472;26;7;7;10;9;33
5473;26;4;17;10;16;47
5474;26;11;9;7;14;41
5475;26;12;10;9;6;37
5476;26;4;12;8;10;34
5477;26;11;13;4;4;32
5478;26;9;4;8;12;33
5479;26;5;12;5;11;33
5480;26;5;10;9;9;33
5481;26;6;10;7;8;31
5482;26;13;9;5;9;36
5483;26;15;8;15;8;46
5484;26;4;3;15;8;30
5485;26;2;2;12;13;29
5486;26;6;8;4;9;27
5487;26;5;7;7;6;25
5488;26;8;10;5;7;30
5489;26;13;12;9;12;46
5490;26;12;8;13;11;44
5491;26;4;16;6;3;29
5492;26;8;12;9;9;38
5493;26;5;11;10;4;30
5494;26;8;12;4;7;31
5495;26;2;8;8;8;26
5496;26;7;4;9;9;29
5497;26;10;11;7;13;41
5498;26;6;6;14;13;39
5499;26;10;12;9;9;40
5500;26;4;13;9;6;32
5501;26;3;5;14;14;36
5502;26;9;9;9;6;33
5503;26;3;11;5;10;29
5504;26;9;9;10;18;46
5505;26;7;9;6;12;34
5506;26;8;4;8;9;29
5507;26;10;13;6;6;35
5508;26;5;9;9;6;29
5509;26;9;8;9;5;31
5510;26;8;8;9;4;29
5511;26;9;9;18;10;46
5512;26;10;0;13;12;35
5513;26;5;14;9;8;36
5514;26;7;7;4;7;25
5515;26;13;5;10;9;37
5516;26;10;10;11;6;37
5517;26;8;10;10;11;39
5518;26;12;4;9;9;34
5519;26;8;1;9;6;24
5520;26;5;10;12;15;42
5521;26;8;9;6;8;31
5522;26;7;11;9;4;31
5523;26;10;14;6;18;48
5524;26;9;10;9;10;38
5525;26;4;10;13;11;38
5526;26;3;11;14;13;41
5527;26;6;4;4;10;24
5528;26;6;17;8;15;46
5529;26;9;11;6;10;36
5530;26;12;9;12;6;39
5531;26;6;10;11;6;33
5532;26;4;8;10;5;27
5533;26;10;9;9;8;36
5534;26;11;10;11;7;39
5535;26;7;8;4;7;26
5536;26;13;10;17;9;49
5537;26;8;11;7;12;38
5538;26;12;8;5;11;36
5539;26;5;7;13;6;31
5540;26;4;6;8;10;28
5541;26;7;11;7;7;32
5542;26;6;10;10;13;39
5543;26;4;12;9;11;36
5544;26;7;8;14;8;37
5545;26;8;10;4;11;33
5546;26;7;3;12;7;29
5547;26;9;14;8;10;41
5548;26;5;11;4;13;33
5549;26;7;13;6;8;34
5550;26;8;8;12;10;38
5551;26;12;8;12;6;38
5552;26;9;7;17;5;38
5553;26;4;8;10;8;30
5554;26;8;14;10;5;37
5555;26;8;13;9;4;34
5556;26;10;4;10;7;31
5557;26;8;9;9;7;33
5558;26;10;5;6;5;26
5559;26;7;8;12;7;34
5560;26;10;3;6;5;24
5561;26;6;8;9;8;31
5562;26;3;11;9;3;26
5563;26;11;11;7;9;38
5564;26;11;11;7;6;35
5565;26;6;8;8;5;27
5566;26;9;11;12;12;44
5567;26;13;5;14;8;40
5568;26;8;16;11;10;45
5569;26;7;2;7;5;21
5570;26;7;12;11;11;41
5571;26;7;8;7;9;31
5572;26;7;10;14;10;41
5573;26;4;9;7;11;31
5574;26;3;13;6;11;33
5575;26;8;9;7;9;33
5576;26;5;7;7;7;26
5577;26;9;8;10;14;41
5578;26;7;12;6;10;35
5579;26;8;9;6;12;35
5580;26;8;14;12;3;37
5581;26;8;13;10;12;43
5582;26;9;7;7;6;29
5583;26;7;12;15;5;39
5584;26;12;5;7;5;29
5585;26;5;8;11;11;35
5586;26;7;6;9;9;31
5587;26;9;7;11;8;35
5588;26;2;6;6;10;24
5589;26;13;5;3;3;24
5590;26;6;14;8;10;38
5591;26;3;8;11;5;27
5592;26;8;12;12;13;45
5593;26;8;6;12;9;35
5594;26;5;13;8;13;39
5595;26;6;5;5;10;26
5596;26;15;8;8;6;37
5597;26;5;9;8;14;36
5598;26;8;10;8;6;32
5599;26;6;11;8;7;32
5600;26;7;3;10;9;29
5601;26;6;7;3;14;30
5602;26;7;16;12;7;42
5603;26;8;9;10;12;39
5604;26;5;5;5;8;23
5605;26;6;6;5;8;25
5606;26;7;12;12;10;41
5607;26;5;10;5;6;26
5608;26;8;7;9;10;34
5609;26;5;7;8;4;24
5610;26;8;9;8;11;36
5611;26;8;7;11;13;39
5612;26;13;9;13;9;44
5613;26;15;6;9;11;41
5614;26;7;11;17;7;42
5615;26;5;6;8;8;27
5616;26;11;4;12;11;38
5617;26;6;8;7;10;31
5618;26;4;12;7;5;28
5619;26;7;4;8;11;30
5620;28;334;334;330;330;1328
5621;28;275;294;269;296;1134
5622;28;240;288;292;302;1122
5623;28;238;271;269;264;1042
5624;28;237;263;231;242;973
5625;28;226;251;218;248;943
5626;28;192;227;246;219;884
5627;28;218;219;250;238;925
5628;28;186;234;206;246;872
5629;28;185;225;258;194;862
5630;28;175;198;202;200;775
5631;28;182;200;184;192;758
5632;28;149;199;174;181;703
5633;28;139;185;174;174;672
5634;28;121;181;164;154;620
5635;28;150;159;154;163;626
5636;28;137;156;163;131;587
5637;28;117;144;156;150;567
5638;28;144;146;145;150;585
5639;28;147;129;134;135;545
5640;28;121;135;136;115;507
5641;28;101;125;112;125;463
5642;28;84;106;140;103;433
5643;28;109;141;114;85;449
5644;28;103;125;108;85;421
5645;28;75;107;86;103;371
5646;28;60;92;108;103;363
5647;28;85;91;104;89;369
5648;28;77;89;82;103;351
5649;28;75;87;75;76;313
5650;28;57;96;95;75;323
5651;28;67;86;87;86;326
5652;28;68;81;87;68;304
5653;28;75;76;84;68;303
5654;28;61;62;53;73;249
5655;28;70;62;73;62;267
5656;28;49;59;75;63;246
5657;28;61;54;64;56;235
5658;28;50;67;60;51;228
5659;28;42;57;45;58;202
5660;28;42;62;56;40;200
5661;28;51;57;45;46;199
5662;28;45;56;49;40;190
5663;28;41;51;50;49;191
5664;28;49;43;50;52;194
5665;28;29;38;52;46;165
5666;28;32;41;47;48;168
5667;28;54;29;48;30;161
5668;28;34;43;38;52;167
5669;28;41;31;39;38;149
5670;28;32;43;39;34;148
5671;28;32;30;41;39;142
5672;28;32;34;36;40;142
5673;28;27;40;40;26;133
5674;28;40;26;30;39;135
5675;28;23;33;37;32;125
5676;28;30;28;28;32;118
5677;28;12;25;40;23;100
5678;28;24;26;24;30;104
5679;28;26;29;32;22;109
5680;28;28;21;26;22;97
5681;28;31;18;28;28;105
5682;28;21;17;24;27;89
5683;28;22;33;31;24;110
5684;28;22;28;22;23;95
5685;28;23;28;26;21;98
5686;28;25;27;27;23;102
5687;28;19;20;16;25;80
5688;28;18;27;16;23;84
5689;28;17;23;22;18;80
5690;28;18;15;23;19;75
5691;28;19;16;23;21;79
5692;28;19;16;20;18;73
5693;28;9;24;14;14;61
5694;28;15;26;19;10;70
5695;28;13;21;21;15;70
5696;28;15;23;18;16;72
5697;28;14;22;17;18;71
5698;28;17;13;17;18;65
5699;28;12;20;16;10;58
5700;28;15;20;21;17;73
5701;28;20;15;11;19;65
5702;28;8;9;24;12;53
5703;28;6;11;20;11;48
5704;28;6;12;12;16;46
5705;28;10;10;5;14;39
5706;28;19;11;9;20;59
5707;28;9;18;14;12;53
5708;28;8;20;9;11;48
5709;28;9;18;22;18;67
5710;28;18;14;10;12;54
5711;28;16;13;12;10;51
5712;28;9;12;19;12;52
5713;28;11;11;12;13;47
5714;28;8;14;17;20;59
5715;28;15;18;11;12;56
5716;28;8;16;11;18;53
5717;28;11;9;22;16;58
5718;28;12;14;11;7;44
5719;28;11;10;10;6;37
5720;28;12;17;13;9;51
5721;28;10;14;13;11;48
5722;28;8;8;14;10;40
5723;28;6;16;17;9;48
5724;28;6;12;10;15;43
5725;28;13;18;9;9;49
5726;28;9;11;15;9;44
5727;28;9;13;11;11;44
5728;28;5;5;12;13;35
5729;28;9;8;8;11;36
5730;28;9;20;12;9;50
5731;28;6;14;9;11;40
5732;28;8;12;16;8;44
5733;28;9;8;8;6;31
5734;28;5;10;19;7;41
5735;28;15;7;11;18;51
5736;28;12;9;7;17;45
5737;28;10;15;8;10;43
5738;28;6;14;11;5;36
5739;28;4;10;13;13;40
5740;28;9;8;12;6;35
5741;28;9;8;11;10;38
5742;28;7;9;8;12;36
5743;28;12;14;7;15;48
5744;28;12;14;12;9;47
5745;28;10;11;5;10;36
5746;28;15;11;15;9;50
5747;28;12;14;9;15;50
5748;28;14;8;10;9;41
5749;28;11;12;8;14;45
5750;28;10;10;7;12;39
5751;28;9;9;6;7;31
5752;28;10;14;11;10;45
5753;28;7;7;8;11;33
5754;28;10;14;9;11;44
5755;28;5;8;11;10;34
5756;28;7;5;14;10;36
5757;28;10;7;11;10;38
5758;28;5;7;15;9;36
5759;28;13;7;9;15;44
5760;28;11;7;9;6;33
5761;28;8;13;9;14;44
5762;28;7;10;11;10;38
5763;28;6;9;9;10;34
5764;28;8;10;11;18;47
5765;28;11;9;12;15;47
5766;28;5;17;10;5;37
5767;28;9;7;16;15;47
5768;28;10;10;8;8;36
5769;28;10;13;15;7;45
5770;28;5;4;5;7;21
5771;28;8;6;9;9;32
5772;28;9;9;18;10;46
5773;28;11;11;5;10;37
5774;28;1;6;9;11;27
5775;28;6;9;6;13;34
5776;28;6;11;11;9;37
5777;28;11;8;7;11;37
5778;28;10;7;5;5;27
5779;28;13;12;9;14;48
5780;28;8;10;6;14;38
5781;28;12;13;7;5;37
5782;28;8;13;10;12;43
5783;28;6;8;11;12;37
5784;28;10;6;4;10;30
5785;28;10;14;10;11;45
5786;28;7;12;8;8;35
5787;28;10;6;15;9;40
5788;28;7;10;10;5;32
5789;28;10;9;14;13;46
5790;28;7;11;9;8;35
5791;28;8;11;7;5;31
5792;28;6;12;8;12;38
5793;28;4;8;10;10;32
5794;28;8;13;11;5;37
5795;28;5;12;12;13;42
5796;28;10;12;8;12;42
5797;28;10;6;9;6;31
5798;28;8;6;13;8;35
5799;28;11;11;6;6;34
5800;28;12;9;7;9;37
5801;28;10;12;8;11;41
5802;28;9;7;13;5;34
5803;28;3;5;14;6;28
5804;28;7;6;11;10;34
5805;28;7;11;8;16;42
5806;28;10;5;5;14;34
5807;28;9;6;8;10;33
5808;28;9;12;4;6;31
5809;28;6;7;2;13;28
5810;28;9;16;13;10;48
5811;28;15;5;8;20;48
5812;28;9;8;9;6;32
5813;28;6;9;5;10;30
5814;28;11;6;9;4;30
5815;28;5;9;9;13;36
5816;28;8;11;10;9;38
5817;28;4;8;8;9;29
5818;28;8;1;9;9;27
5819;28;7;6;14;4;31
5820;28;5;11;7;8;31
5821;28;4;12;9;9;34
5822;28;7;12;9;14;42
5823;28;6;7;8;9;30
5824;28;7;8;4;8;27
5825;28;8;12;9;10;39
5826;28;8;10;8;9;35
5827;28;10;10;8;14;42
5828;28;5;6;6;14;31
5829;28;7;8;8;8;31
5830;28;3;7;11;10;31
5831;28;5;7;12;7;31
5832;28;4;12;6;5;27
5833;28;10;10;6;4;30
5834;28;12;10;12;13;47
5835;28;4;10;13;12;39
5836;28;8;8;11;9;36
5837;28;1;9;7;10;27
5838;28;5;12;10;8;35
5839;28;9;9;8;11;37
5840;28;8;9;7;10;34
5841;28;6;11;11;14;42
5842;28;5;8;12;9;34
5843;28;10;7;8;6;31
5844;28;10;12;14;7;43
5845;28;8;14;4;10;36
5846;28;4;13;4;6;27
5847;28;11;7;8;6;32
5848;28;7;11;10;11;39
5849;28;7;8;9;13;37
5850;28;6;8;16;12;42
5851;28;10;7;12;3;32
5852;28;9;10;11;6;36
5853;28;5;6;9;10;30
5854;28;11;9;6;5;31
5855;28;6;8;6;11;31
5856;28;7;10;4;5;26
5857;28;3;11;7;8;29
5858;28;9;11;5;7;32
5859;28;2;4;8;8;22
5860;28;7;9;9;11;36
5861;28;2;10;5;4;21
5862;28;8;5;12;8;33
5863;28;4;4;10;6;24
5864;28;10;10;11;2;33
5865;28;9;5;9;10;33
5866;28;4;8;11;4;27
5867;28;8;7;9;15;39
5868;28;5;9;4;9;27
5869;28;5;10;9;8;32
5870;28;13;8;13;12;46
5871;28;7;11;7;8;33
5872;28;9;10;11;10;40
5873;28;10;9;9;17;45
5874;28;6;8;13;16;43
5875;28;8;6;8;9;31
5876;28;10;10;11;10;41
5877;28;11;4;6;5;26
5878;28;11;10;9;9;39
5879;28;9;10;4;10;33
5880;28;11;10;9;6;36
5881;28;7;7;3;11;28
5882;28;11;9;11;5;36
5883;28;7;11;11;8;37
5884;28;8;4;12;5;29
5885;28;7;8;5;9;29
5886;28;4;7;6;4;21
5887;28;3;8;6;12;29
5888;28;6;12;11;7;36
5889;28;9;11;8;10;38
5890;28;8;9;7;8;32
5891;28;8;14;6;8;36
5892;28;5;8;7;8;28
5893;28;6;3;8;17;34
5894;28;2;16;13;12;43
5895;28;7;7;12;12;38
5896;28;16;4;4;12;36
5897;28;7;2;13;9;31
5898;28;8;3;5;11;27
5899;28;4;5;11;9;29
5900;28;5;6;5;7;23
5901;28;4;11;13;8;36
5902;28;7;8;12;12;39
5903;28;11;8;10;10;39
5904;28;9;9;3;13;34
5905;28;5;6;8;6;25
5906;28;7;4;8;6;25
5907;28;9;9;5;9;32
5908;28;8;10;11;6;35
5909;28;10;9;6;11;36
5910;28;7;9;10;5;31
5911;28;6;7;9;8;30
5912;28;10;11;9;9;39
5913;28;8;14;7;12;41
5914;28;5;5;13;8;31
5915;28;3;9;10;7;29
5916;28;7;6;4;8;25
5917;28;5;11;9;7;32
5918;28;7;12;9;11;39
5919;28;7;10;12;8;37
5920;28;12;6;13;11;42
5921;28;8;14;6;9;37
5922;28;7;9;10;5;31
5923;28;11;8;15;7;41
5924;28;4;9;2;11;26
5925;28;2;9;4;12;27
5926;28;6;10;6;7;29
5927;28;9;9;8;9;35
5928;28;6;6;12;10;34
5929;28;4;8;9;5;26
5930;28;8;6;4;13;31
5931;28;10;6;9;6;31
5932;28;7;12;7;9;35
5933;28;7;7;4;9;27
5934;28;6;10;18;5;39
5935;28;8;6;13;11;38
5936;28;6;15;9;16;46
5937;28;5;15;4;9;33
5938;28;7;10;10;13;40
5939;28;4;14;8;8;34
5940;28;5;8;11;9;33
5941;28;9;16;8;9;42
5942;28;7;6;13;8;34
5943;28;4;6;13;8;31
5944;28;6;8;4;10;28
5945;28;11;9;9;10;39
5946;28;2;15;8;12;37
5947;28;6;10;6;7;29
5948;28;7;6;8;4;25
5949;28;6;4;8;7;25
5950;28;3;5;9;13;30
5951;28;18;5;9;5;37
5952;28;6;6;8;5;25
5953;28;8;8;9;9;34
5954;28;6;9;7;6;28
5955;28;5;8;11;10;34
5956;28;10;9;6;5;30
5957;28;12;5;9;10;36
5958;28;9;10;6;9;34
5959;28;9;4;10;9;32
5960;28;5;4;13;10;32
5961;28;12;10;8;12;42
5962;28;4;11;7;8;30
5963;28;7;9;10;10;36
5964;28;10;13;10;12;45
5965;28;7;7;6;14;34
5966;28;16;12;10;11;49
5967;28;9;7;4;10;30
5968;28;5;8;14;8;35
5969;28;10;9;9;5;33
5970;28;4;10;10;7;31
5971;28;4;8;13;13;38
5972;28;7;9;10;11;37
5973;28;7;9;11;6;33
5974;28;8;15;8;9;40
5975;28;12;5;4;8;29
5976;28;6;5;8;8;27
5977;28;2;5;9;7;23
5978;28;3;13;6;14;36
5979;28;6;7;9;11;33
5980;28;7;9;9;6;31
5981;28;8;13;13;10;44
5982;28;12;4;7;10;33
5983;28;7;4;12;16;39
5984;28;10;11;8;12;41
5985;28;9;15;6;4;34
5986;28;6;9;9;7;31
5987;28;8;9;6;7;30
5988;28;9;6;8;8;31
5989;28;3;8;9;13;33
5990;28;6;9;9;9;33
5991;28;10;10;6;11;37
5992;28;6;11;10;12;39
5993;28;10;11;12;6;39
5994;28;6;6;7;8;27
5995;28;5;6;13;4;28
5996;28;5;10;12;6;33
5997;28;2;9;7;6;24
5998;28;8;6;10;11;35
5999;28;9;9;4;8;30
6000;28;10;10;10;8;38
6001;28;11;8;8;8;35
6002;28;10;7;8;9;34
6003;28;10;4;10;9;33
6004;28;8;6;8;11;33
6005;28;3;7;6;5;21
6006;28;7;12;11;9;39
6007;28;9;12;9;8;38
6008;28;7;10;10;12;39
6009;28;11;8;8;5;32
6010;28;6;9;10;8;33
6011;28;6;7;9;6;28
6012;28;5;11;9;7;32
6013;28;5;8;7;9;29
6014;28;11;6;14;7;38
6015;28;8;3;9;12;32
6016;28;6;10;10;17;43
6017;28;6;7;15;9;37
6018;28;4;10;12;9;35
6019;28;9;6;7;8;30
6020;28;5;9;11;8;33
6021;28;6;9;7;16;38
6022;28;6;5;9;10;30
6023;28;8;8;5;12;33
6024;28;5;11;11;8;35
6025;28;4;4;12;7;27
6026;28;9;8;9;8;34
6027;28;6;9;10;7;32
6028;28;8;8;14;9;39
6029;28;6;9;7;6;28
6030;28;7;5;6;8;26
6031;28;8;11;6;8;33
6032;28;6;5;12;6;29
6033;28;8;9;10;8;35
6034;28;7;11;6;12;36
6035;28;6;6;7;9;28
6036;28;7;7;7;6;27
6037;28;6;10;10;10;36
6038;28;4;8;8;10;30
6039;28;9;8;14;8;39
6040;28;9;13;5;4;31
6041;28;4;6;11;5;26
6042;28;8;5;8;3;24
6043;28;8;14;7;7;36
6044;28;3;4;7;9;23
6045;28;5;4;5;7;21
6046;28;10;11;14;4;39
6047;28;7;10;6;9;32
6048;28;11;11;11;6;39
6049;28;8;8;7;6;29
6050;28;10;5;5;8;28
6051;28;6;10;6;10;32
6052;28;7;7;10;9;33
6053;28;7;11;9;10;37
6054;28;12;7;14;13;46
6055;28;3;11;9;8;31
6056;28;5;9;12;9;35
6057;28;10;9;13;9;41
6058;28;7;12;15;7;41
6059;28;10;13;6;6;35
6060;28;7;8;8;5;28
6061;28;7;8;10;7;32
6062;28;12;6;9;7;34
6063;28;6;8;10;4;28
6064;28;8;8;14;4;34
6065;30;362;377;357;355;1451
6066;30;303;314;330;323;1270
6067;30;307;326;343;302;1278
6068;30;284;328;308;289;1209
6069;30;281;300;271;288;1140
6070;30;257;283;300;248;1088
6071;30;223;247;257;253;980
6072;30;217;272;228;243;960
6073;30;207;257;253;226;943
6074;30;198;230;247;225;900
6075;30;202;236;225;213;876
6076;30;192;200;216;187;795
6077;30;164;222;215;189;790
6078;30;187;217;192;195;791
6079;30;160;202;163;163;688
6080;30;145;194;157;178;674
6081;30;137;159;168;171;635
6082;30;135;154;169;161;619
6083;30;151;170;151;164;636
6084;30;124;137;160;143;564
6085;30;125;148;130;169;572
6086;30;146;148;130;118;542
6087;30;115;132;131;113;491
6088;30;106;120;146;113;485
6089;30;104;106;135;105;450
6090;30;110;119;146;97;472
6091;30;90;107;120;133;450
6092;30;117;110;104;110;441
6093;30;76;101;103;100;380
6094;30;98;96;84;87;365
6095;30;74;82;86;83;325
6096;30;68;82;98;87;335
6097;30;69;80;74;78;301
6098;30;69;80;80;85;314
6099;30;79;86;64;77;306
6100;30;51;96;87;78;312
6101;30;61;78;77;64;280
6102;30;77;67;65;61;270
6103;30;52;62;80;72;266
6104;30;67;74;55;61;257
6105;30;44;70;57;38;209
6106;30;51;53;63;42;209
6107;30;42;54;56;64;216
6108;30;55;55;54;47;211
6109;30;44;47;53;49;193
6110;30;50;58;41;40;189
6111;30;40;39;40;45;164
6112;30;34;51;59;41;185
6113;30;45;30;45;51;171
6114;30;38;51;44;44;177
6115;30;38;40;40;44;162
6116;30;26;33;41;31;131
6117;30;29;25;38;42;134
6118;30;33;42;32;39;146
6119;30;34;33;32;42;141
6120;30;45;31;39;39;154
6121;30;41;31;22;37;131
6122;30;29;32;35;37;133
6123;30;37;25;31;33;126
6124;30;26;40;34;22;122
6125;30;21;25;23;27;96
6126;30;18;20;35;30;103
6127;30;26;31;30;26;113
6128;30;17;21;27;20;85
6129;30;18;25;20;21;84
6130;30;19;29;16;22;86
6131;30;25;19;25;24;93
6132;30;16;20;18;27;81
6133;30;23;20;21;21;85
6134;30;18;22;19;16;75
6135;30;16;22;24;19;81
6136;30;16;25;23;17;81
6137;30;21;21;18;21;81
6138;30;17;16;30;16;79
6139;30;17;15;24;21;77
6140;30;18;26;16;19;79
6141;30;21;31;17;18;87
6142;30;11;15;16;19;61
6143;30;9;18;13;17;57
6144;30;9;16;8;14;47
6145;30;15;19;20;12;66
6146;30;15;13;11;13;52
6147;30;15;19;14;19;67
6148;30;15;16;21;17;69
6149;30;10;15;16;19;60
6150;30;6;17;21;10;54
6151;30;13;16;23;9;61
6152;30;17;22;15;8;62
6153;30;9;14;18;10;51
6154;30;18;18;20;20;76
6155;30;14;16;16;11;57
6156;30;16;14;11;18;59
6157;30;6;16;15;13;50
6158;30;9;9;13;9;40
6159;30;7;11;14;11;43
6160;30;6;14;7;14;41
6161;30;15;12;12;15;54
6162;30;19;10;14;18;61
6163;30;12;7;8;17;44
6164;30;12;11;12;8;43
6165;30;10;14;18;9;51
6166;30;9;11;11;13;44
6167;30;9;14;14;14;51
6168;30;6;20;11;6;43
6169;30;11;11;12;11;45
6170;30;7;16;6;7;36
6171;30;6;6;13;12;37
6172;30;7;14;14;14;49
6173;30;8;7;11;6;32
6174;30;10;10;14;12;46
6175;30;7;12;13;13;45
6176;30;5;12;11;12;40
6177;30;14;13;11;7;45
6178;30;5;11;9;11;36
6179;30;11;8;11;12;42
6180;30;10;11;14;12;47
6181;30;13;10;16;15;54
6182;30;9;10;6;11;36
6183;30;9;12;17;11;49
6184;30;7;9;4;11;31
6185;30;4;5;11;10;30
6186;30;14;12;10;20;56
6187;30;11;10;11;8;40
6188;30;11;10;10;13;44
6189;30;11;16;14;14;55
6190;30;7;9;11;7;34
6191;30;9;18;12;15;54
6192;30;8;9;10;8;35
6193;30;13;15;10;10;48
6194;30;10;12;17;16;55
6195;30;10;11;8;12;41
6196;30;6;11;8;11;36
6197;30;12;8;14;9;43
6198;30;10;9;10;12;41
6199;30;11;9;12;8;40
6200;30;7;15;16;9;47
6201;30;9;12;12;13;46
6202;30;8;10;13;14;45
6203;30;7;10;7;9;33
6204;30;12;15;7;8;42
6205;30;7;10;13;9;39
6206;30;6;7;14;7;34
6207;30;11;9;5;9;34
6208;30;8;16;14;7;45
6209;30;6;8;9;8;31
6210;30;7;12;7;13;39
6211;30;12;3;6;10;31
6212;30;8;11;11;14;44
6213;30;7;7;11;10;35
6214;30;8;12;5;13;38
6215;30;7;8;9;10;34
6216;30;12;11;12;9;44
6217;30;12;14;17;9;52
6218;30;6;9;10;13;38
6219;30;8;10;10;18;46
6220;30;8;10;12;4;34
6221;30;13;10;13;11;47
6222;30;8;8;11;13;40
6223;30;9;8;9;8;34
6224;30;8;10;12;13;43
6225;30;11;15;12;11;49
6226;30;9;9;14;9;41
6227;30;5;7;12;8;32
6228;30;10;6;4;10;30
6229;30;6;9;10;10;35
6230;30;13;10;3;11;37
6231;30;11;16;4;10;41
6232;30;6;11;8;10;35
6233;30;5;10;7;7;29
6234;30;10;8;10;9;37
6235;30;7;11;12;10;40
6236;30;7;8;6;11;32
6237;30;10;12;6;12;40
6238;30;6;7;15;7;35
6239;30;7;9;9;11;36
6240;30;13;15;8;9;45
6241;30;7;9;8;8;32
6242;30;12;8;3;10;33
6243;30;10;9;14;10;43
6244;30;5;9;8;6;28
6245;30;6;10;8;7;31
6246;30;7;13;11;9;40
6247;30;5;11;8;8;32
6248;30;7;13;13;13;46
6249;30;11;2;15;6;34
6250;30;3;10;11;11;35
6251;30;6;11;8;11;36
6252;30;14;10;9;2;35
6253;30;7;13;7;15;42
6254;30;6;10;7;10;33
6255;30;11;18;9;9;47
6256;30;12;11;11;7;41
6257;30;3;8;10;5;26
6258;30;13;10;13;14;50
6259;30;11;13;6;12;42
6260;30;5;9;18;4;36
6261;30;4;12;7;9;32
6262;30;5;7;13;7;32
6263;30;9;10;14;11;44
6264;30;5;6;11;7;29
6265;30;7;9;11;8;35
6266;30;5;12;20;8;45
6267;30;8;6;8;8;30
6268;30;7;12;13;10;42
6269;30;9;8;14;12;43
